Words,All,Tree Hole,Wailing Wall,Unique Tree Hole,Unique Wailing Wall,Both
我,364,296,106,248,58,48
你,244,90,173,60,143,30
自己,101,74,35,63,24,11
父母,85,54,26,48,20,6
游戏,84,43,34,39,30,4
人,84,59,28,51,20,8
她,73,46,14,44,12,2
他们,60,32,28,28,24,4
说,50,34,13,31,10,3
希望,48,25,27,17,19,8
没有,42,31,13,26,8,5
真的,41,26,14,23,11,3
一个,40,25,13,22,10,3
活着,40,25,16,23,14,2
觉得,38,28,14,24,10,4
可以,35,15,22,12,19,3
好,34,26,12,20,6,6
灯,33,28,19,14,5,14
自由,32,19,17,13,11,6
快乐,32,21,22,10,11,11
玩,30,15,15,14,14,1
如果,30,15,12,15,12,0
喜欢,29,19,14,15,10,4
不要,29,15,15,11,11,4
生活,29,19,16,13,10,6
想,29,17,13,15,11,2
“,29,17,16,13,12,4
”,29,17,16,13,12,4
孩子,29,22,9,20,7,2
人生,28,23,8,20,5,3
现在,27,18,12,14,8,4
还是,27,14,10,13,9,1
看到,27,15,12,11,8,4
打,27,11,14,10,13,1
已经,26,19,9,13,3,6
不是,25,19,6,17,4,2
结婚,25,24,0,24,0,0
我们,25,11,10,9,8,2
你们,24,13,10,13,10,0
但是,24,16,8,15,7,1
选择,24,14,10,14,10,0
这个,23,17,4,16,3,1
微博,23,12,15,6,9,6
把,23,14,10,12,8,2
因为,23,14,9,13,8,1
姐妹,22,3,19,2,18,1
今天,22,18,9,13,4,5
都是,20,10,8,9,7,1
世界,20,14,8,12,6,2
什么,20,16,6,13,3,3
工作,20,19,1,19,1,0
朋友,19,12,6,11,5,1
再,19,8,9,8,9,0
就是,19,15,4,15,4,0
不知道,19,6,12,5,11,1
自杀,19,12,6,12,6,0
他,19,16,2,16,2,0
痛苦,19,11,8,11,8,0
也是,19,17,3,16,2,1
还有,19,10,11,8,9,2
不会,19,11,9,10,8,1
一直,18,12,7,11,6,1
知道,18,10,9,9,8,1
不能,17,10,8,9,7,1
为什么,17,14,3,14,3,0
东西,17,12,4,11,3,1
才,17,15,2,15,2,0
上,17,13,4,12,3,1
离,17,11,13,4,6,7
一样,16,15,4,12,1,3
这样,16,10,6,10,6,0
开心,16,11,12,4,5,7
一定要,16,10,6,9,5,1
只是,15,13,5,10,2,3
时候,15,8,7,6,5,2
怎么,15,10,1,10,1,0
理解,15,11,4,11,4,0
评论,14,3,4,1,2,2
感觉,14,14,2,12,0,2
我妈,14,14,1,13,0,1
还在,14,9,3,7,1,2
方式,14,4,9,4,9,0
里,14,9,6,5,2,4
生命,13,7,3,7,3,0
别,13,5,6,5,6,0
多,13,11,3,10,2,1
大家,13,9,4,8,3,1
难过,13,10,2,10,2,0
为,13,9,2,8,1,1
走,13,7,6,6,5,1
可是,13,11,1,10,0,1
最后,13,6,6,5,5,1
博主,13,8,1,7,0,1
事,13,8,7,6,5,2
离开,12,7,6,5,4,2
还要,12,11,1,11,1,0
苏州,12,1,1,1,1,0
无法,12,6,4,4,2,2
机,12,5,8,4,7,1
更,12,7,5,5,3,2
一起,12,6,6,5,5,1
报警,12,1,0,1,0,0
一点,12,9,3,7,1,2
这种,12,9,4,7,2,2
愿,12,6,9,3,6,3
这条,12,7,7,4,4,3
别人,11,10,1,9,0,1
得,11,9,3,8,2,1
也不,11,8,4,7,3,1
所以,11,6,5,5,4,1
找,11,8,2,8,2,0
看看,11,4,5,4,5,0
想要,11,9,3,8,2,1
这样的,11,9,1,9,1,0
爱,11,6,3,6,3,0
事情,10,7,3,6,2,1
中,10,7,5,5,3,2
最,10,4,5,4,5,0
相亲,10,9,2,8,1,1
死了,10,7,4,5,2,2
一切,10,7,3,6,2,1
一些,10,9,0,9,0,0
连,10,9,1,9,1,0
天堂,10,3,10,0,7,3
那个,10,6,5,4,3,2
一定,10,4,6,4,6,0
开,10,7,8,2,3,5
公安,10,0,0,0,0,0
@,10,0,0,0,0,0
然后,9,7,1,7,1,0
放弃,9,7,2,7,2,0
还会,9,5,5,4,4,1
好好,9,6,5,4,3,2
回来,9,5,5,4,4,1
这么,9,7,1,7,1,0
谁,9,7,3,6,2,1
心,9,5,8,1,4,4
只要,9,5,4,5,4,0
发现,9,7,1,7,1,0
很多,9,6,3,5,2,1
死,9,6,3,6,3,0
比,9,5,5,4,4,1
勇气,9,7,4,5,2,2
我自己,9,8,3,6,1,2
只,9,8,3,6,1,2
以后,9,2,6,2,6,0
可能,8,4,3,4,3,0
难受,8,6,4,4,2,2
勇敢,8,2,6,2,6,0
努力,8,8,1,7,0,1
永远,8,8,1,7,0,1
远离,8,7,2,6,1,1
爸妈,8,7,1,7,1,0
决定,8,5,5,3,3,2
钱,8,5,2,5,2,0
甚至,8,6,3,5,2,1
好难,8,8,0,8,0,0
买,8,3,5,3,5,0
妈妈,8,5,3,5,3,0
想死,8,6,2,6,2,0
应该,8,5,4,3,2,2
或者,8,5,3,4,2,1
下辈子,8,4,6,2,4,2
家里,8,4,2,4,2,0
虽然,8,8,5,3,0,5
祝,7,4,5,2,3,2
这些,7,5,2,5,2,0
也许,7,4,4,3,3,1
独立,7,5,2,5,2,0
搬出去,7,3,2,3,2,0
就会,7,3,5,2,4,1
记得,7,2,6,1,5,1
问题,7,3,1,3,1,0
点,7,5,1,5,1,0
最近,7,5,2,5,2,0
这么多,7,4,2,4,2,0
继续,7,5,2,5,2,0
网友,7,3,3,3,3,0
与,7,6,6,1,1,5
而,7,4,4,2,2,2
也有,7,4,6,1,3,3
当,7,2,3,2,3,0
劝,7,2,5,2,5,0
一种,7,3,5,2,4,1
伤害,7,3,4,3,4,0
小时候,7,6,1,6,1,0
家庭,7,7,4,3,0,4
坚持,7,6,0,6,0,0
之前,7,5,2,5,2,0
它,7,4,2,4,2,0
好像,7,7,3,4,0,3
不想,7,6,1,6,1,0
真正,7,4,2,4,2,0
哭,7,6,2,5,1,1
在那边,7,5,6,1,2,4
用,7,3,4,3,4,0
地,7,5,2,5,2,0
所有,6,3,3,3,3,0
后,6,3,2,3,2,0
机会,6,1,6,0,5,1
之后,6,3,3,3,3,0
未来,6,5,2,4,1,1
惩罚,6,2,4,2,4,0
控制欲,6,5,1,5,1,0
开始,6,4,2,4,2,0
新,6,2,4,2,4,0
意义,6,5,1,5,1,0
小,6,3,3,2,2,1
以为,6,6,0,6,0,0
无论,6,3,4,2,3,1
其实,6,5,3,3,1,2
找到,6,3,2,2,1,1
只有,6,5,1,5,1,0
为了,6,4,2,4,2,0
叫,6,3,4,1,2,2
大,6,5,0,5,0,0
共情,6,3,2,3,2,0
换,6,3,3,3,3,0
扔,6,5,0,5,0,0
出,6,1,5,1,5,0
警察,6,2,0,2,0,0
请,6,3,2,1,0,2
那么,6,5,2,4,1,1
逼死,6,4,2,4,2,0
一,6,3,4,0,1,3
一下,6,4,2,3,1,1
还好,6,5,3,3,1,2
过年,6,6,4,2,0,4
突然,6,6,3,3,0,3
看完,6,5,1,5,1,0
不用,6,3,3,2,2,1
一次,6,5,1,5,1,0
解脱,6,4,5,1,2,3
自私,6,4,2,4,2,0
羡慕,6,4,3,3,2,1
真的好,6,5,2,4,1,1
上班,6,5,1,5,1,0
粉丝,6,3,4,1,2,2
那么多,6,2,4,2,4,0
过去,6,4,3,2,1,2
每个人,6,6,1,5,0,1
活下去,6,5,2,4,1,1
/,6,5,1,5,1,0
活,6,4,2,4,2,0
肯定,5,3,2,3,2,0
获得,5,2,3,2,3,0
很多人,5,3,3,1,1,2
马上,5,3,2,3,2,0
今年,5,4,3,2,1,2
总是,5,3,2,3,2,0
恭喜,5,0,5,0,5,0
恶心,5,4,1,4,1,0
您,5,1,1,1,1,0
人家,5,1,0,1,0,0
再来,5,1,4,1,4,0
骂,5,3,2,3,2,0
感同身受,5,5,1,4,0,1
刚,5,5,2,3,0,2
结束,5,1,4,1,4,0
经历,5,4,1,4,1,0
精神支柱,5,2,2,1,1,1
精神,5,4,1,4,1,0
出来,5,2,3,2,3,0
才是,5,5,0,5,0,0
当时,5,5,2,3,0,2
催婚,5,4,1,4,1,0
以前,5,3,2,3,2,0
回家,5,5,1,4,0,1
命,5,4,1,4,1,0
告诉,5,4,3,2,1,2
听,5,3,2,3,2,0
逃离,5,4,2,3,1,1
那里,5,2,3,1,2,1
一个人,5,3,4,1,2,2
好多,5,2,4,1,3,1
还能,5,1,4,1,4,0
关注,5,2,3,2,3,0
姑娘,5,2,2,2,2,0
除了,5,4,1,4,1,0
你好,5,2,2,2,2,0
宝贝,5,0,5,0,5,0
家人,5,1,2,1,2,0
住,5,1,4,0,3,1
尊重,5,4,1,4,1,0
小姐姐,5,4,2,3,1,1
难,5,5,0,5,0,0
们,5,4,0,4,0,0
受罪,5,3,2,3,2,0
认识,5,2,2,2,2,0
等,5,2,3,2,3,0
正常,5,3,0,3,0,0
乙,5,1,4,1,4,0
是不是,5,3,2,3,2,0
日子,5,5,2,3,0,2
有人,5,2,2,1,1,1
么,5,5,3,2,0,3
且,5,4,1,4,1,0
男,5,4,0,4,0,0
活下来,5,2,3,1,2,1
救,5,2,3,1,2,1
现实,5,4,2,3,1,1
未婚女人,5,0,0,0,0,0
挣扎,5,4,3,2,1,2
看见,5,5,1,4,0,1
昨天,5,3,3,2,2,1
控制,5,3,2,2,1,1
热爱,5,4,2,3,1,1
不好,5,3,2,2,1,1
相信,5,3,1,3,1,0
断绝关系,5,3,1,3,1,0
指责,5,4,0,4,0,0
不过,5,3,3,2,2,1
来说,5,2,2,2,2,0
来生,5,2,4,1,3,1
砸,5,2,4,1,3,1
特别,4,4,1,3,0,1
生子,4,4,0,4,0,0
女,4,4,2,2,0,2
太多,4,2,1,2,1,0
日本,4,2,2,2,2,0
个人,4,3,1,3,1,0
一位,4,2,2,2,2,0
好的,4,2,1,2,1,0
严重,4,2,2,2,2,0
社会,4,4,1,3,0,1
日,4,1,3,1,3,0
安慰,4,2,3,1,2,1
逝者,4,2,1,2,1,0
害死,4,3,1,3,1,0
家,4,1,1,1,1,0
辞职,4,4,0,4,0,0
报,4,1,1,0,0,1
留言,4,1,2,1,2,0
对象,4,3,1,3,1,0
走出来,4,4,1,3,0,1
直接,4,2,0,2,0,0
就像,4,2,2,2,2,0
就这样,4,4,0,4,0,0
评论区,4,3,1,3,1,0
带,4,3,1,3,1,0
害怕,4,3,1,3,1,0
回头,4,1,4,0,3,1
逼,4,4,0,4,0,0
只会,4,3,1,3,1,0
另一个,4,2,2,2,2,0
养,4,2,1,2,1,0
发生,4,3,4,0,1,3
面对,4,2,1,2,1,0
发,4,3,2,2,1,1
反抗,4,2,1,2,1,0
原生家庭,4,2,3,1,2,1
原因,4,4,2,2,0,2
压力,4,4,0,4,0,0
即使,4,4,1,3,0,1
每一个,4,3,1,3,1,0
高中,4,4,1,3,0,1
杀,4,4,1,3,0,1
到底,4,2,2,2,2,0
出去,4,3,1,2,0,1
非要,4,3,1,3,1,0
需要,4,3,0,3,0,0
做出,4,3,1,3,1,0
有没有,4,1,2,0,1,1
更多,4,3,3,1,1,2
遗书,4,3,1,2,0,1
任,4,2,3,1,2,1
回去,4,2,3,1,2,1
那些,4,2,1,2,1,0
唉,4,1,3,1,3,0
那种,4,3,2,2,1,1
哪怕,4,3,1,3,1,0
有一天,4,3,2,2,1,1
听到,4,4,1,3,0,1
都会,4,2,2,2,2,0
里面,4,3,3,0,0,3
可怜,4,4,0,4,0,0
可以是,4,0,1,0,1,0
重要,4,3,1,3,1,0
帮,4,2,1,2,1,0
一天,4,3,2,2,1,1
一辈子,4,3,3,1,1,2
类似,4,4,1,3,0,1
所有人,4,4,1,3,0,1
感受到,4,2,2,2,2,0
摆脱,4,2,1,2,1,0
眼里,4,3,3,1,1,2
我爸,4,4,0,4,0,0
怕,4,3,1,3,1,0
很累,4,4,0,4,0,0
翻,4,4,0,4,0,0
得到,4,4,2,2,0,2
成,4,3,0,3,0,0
懂,4,1,2,1,2,0
自在,4,1,3,1,3,0
心情,4,4,0,4,0,0
心里,4,3,2,2,1,1
美好,4,2,3,1,2,1
见,4,2,2,2,2,0
亲戚,4,4,0,4,0,0
真实,4,2,0,2,0,0
离家出走,4,2,1,2,1,0
并,4,2,3,1,2,1
才能,4,3,1,3,1,0
而已,4,3,1,2,0,1
幸福,4,2,3,1,2,1
根本,4,4,0,4,0,0
想你,4,1,4,0,3,1
想法,4,4,0,4,0,0
联系,4,1,0,1,0,0
整个,4,4,0,4,0,0
折磨,4,2,3,1,2,1
年龄,4,2,1,2,1,0
人间,4,1,3,1,3,0
想着,3,3,0,3,0,0
真心,3,3,0,3,0,0
醒来,3,2,1,2,1,0
烧,3,3,1,2,0,1
后来,3,2,0,2,0,0
回,3,2,2,1,1,1
吃,3,3,0,3,0,0
那边,3,1,1,0,0,1
想过,3,2,1,2,1,0
想起,3,3,0,3,0,0
吵架,3,3,0,3,0,0
呆,3,3,2,1,0,2
有些,3,2,0,2,0,0
唯一,3,3,0,3,0,0
哈哈,3,1,3,0,2,1
而且,3,2,1,1,0,1
干嘛,3,2,1,1,0,1
挺,3,2,2,1,1,1
顺着,3,2,1,2,1,0
祝福,3,3,2,1,0,2
?,3,1,1,1,1,0
鼓励,3,3,0,3,0,0
拥有,3,1,2,1,2,0
麻烦,3,0,1,0,1,0
鬼,3,3,1,2,0,1
答案,3,3,0,3,0,0
算,3,3,0,3,0,0
死亡,3,2,1,2,1,0
才会,3,3,0,3,0,0
管,3,2,0,2,0,0
睡,3,2,0,2,0,0
陌生人,3,3,1,2,0,1
按,3,1,1,1,1,0
所,3,3,0,3,0,0
或许,3,2,2,1,1,1
我家,3,2,1,2,1,0
经济,3,3,0,3,0,0
真累,3,3,0,3,0,0
非常,3,1,2,1,2,0
成年,3,3,0,3,0,0
成功,3,2,1,2,1,0
求求,3,0,2,0,2,0
回来了,3,2,0,2,0,0
曾经,3,3,3,0,0,3
道德,3,1,1,1,1,0
更新,3,1,1,1,1,0
足以,3,3,1,2,0,1
很多很多,3,1,2,1,2,0
完整,3,3,0,3,0,0
看客,3,3,0,3,0,0
实在,3,2,1,2,1,0
花,3,2,1,1,0,1
教,3,2,0,2,0,0
当做,3,3,0,3,0,0
几次,3,1,3,0,2,1
要是,3,1,2,0,1,1
开明,3,2,1,2,1,0
家长,3,2,1,2,1,0
容易,3,3,0,3,0,0
跳楼,3,1,1,1,1,0
对于,3,1,1,1,1,0
在于,3,0,0,0,0,0
敢,3,1,0,1,0,0
导火索,3,3,0,3,0,0
起,3,3,1,2,0,1
直到,3,2,1,2,1,0
小区,3,2,0,2,0,0
赚钱,3,2,1,2,1,0
赚,3,2,1,2,1,0
认为,3,1,1,1,1,0
文字,3,2,1,2,1,0
就算,3,2,1,2,1,0
幸运,3,2,2,1,1,1
说说,3,1,1,1,1,0
说什么,3,0,2,0,2,0
安好,3,1,3,0,2,1
辱骂,3,2,1,2,1,0
过来,3,3,0,3,0,0
自我,3,3,1,2,0,1
遗憾,3,2,1,2,1,0
肖战,3,1,1,1,1,0
地址,3,0,0,0,0,0
地方,3,1,2,1,2,0
城市,3,2,3,0,1,2
提供,3,0,1,0,1,0
多少,3,2,1,2,1,0
够,3,1,1,1,1,0
能力,3,3,0,3,0,0
真好,3,1,2,1,2,0
大学,3,2,1,2,1,0
天上,3,0,3,0,3,0
改变,3,1,3,0,2,1
晚安,3,2,2,1,1,1
失去,3,2,1,2,1,0
怎样,3,2,1,2,1,0
女儿,3,3,0,3,0,0
女孩,3,3,0,3,0,0
这里,3,0,2,0,2,0
她们,3,3,0,3,0,0
能够,3,1,2,1,2,0
脱离,3,2,1,2,1,0
好吃,3,2,2,1,1,1
自,3,0,1,0,1,0
这位,3,2,0,2,0,0
这份,3,2,3,0,1,2
看着,3,0,3,0,3,0
无能为力,3,3,0,3,0,0
  ,3,3,0,3,0,0
不管,3,2,1,1,0,1
全部,3,2,0,2,0,0
不值得,3,2,1,2,1,0
先,3,1,1,1,1,0
作为,3,3,0,3,0,0
po主,3,2,1,1,0,1
从来,3,3,0,3,0,0
不到,3,2,1,2,1,0
书,3,1,1,1,1,0
做人,3,2,1,2,1,0
下次,3,0,3,0,3,0
关,3,1,1,1,1,0
po,3,3,3,0,0,3
不让,3,2,1,2,1,0
也好,3,1,2,1,2,0
下班,3,2,1,1,0,1
不怕,3,1,2,1,2,0
任何,3,2,1,2,1,0
;,3,2,1,2,1,0
?,3,2,3,0,1,2
也可以,3,0,3,0,3,0
任何人,3,3,1,2,0,1
催,3,3,0,3,0,0
体验,3,0,3,0,3,0
做错,3,2,1,2,1,0
全,3,1,2,1,2,0
xz,3,2,3,0,1,2
不要放弃,3,1,2,1,2,0
下,3,2,1,1,0,1
不了,3,2,0,2,0,0
下面,3,2,0,2,0,0
&,3,2,1,2,1,0
写,3,2,0,2,0,0
不敢,3,0,2,0,2,0
关心,3,3,0,3,0,0
以,3,0,3,0,3,0
痛骂,2,0,2,0,2,0
挺好,2,1,2,0,1,1
子女,2,2,0,2,0,0
也不是,2,2,1,1,0,1
走后,2,2,1,1,0,1
掉,2,1,0,1,0,0
姐姐,2,1,2,0,1,1
费,2,0,2,0,2,0
好起来,2,1,1,1,1,0
掌控,2,2,0,2,0,0
妹妹,2,2,0,2,0,0
依然,2,1,2,0,1,1
依旧,2,2,0,2,0,0
妥协,2,2,0,2,0,0
殆尽,2,1,1,1,1,0
不对,2,2,0,2,0,0
完全,2,2,0,2,0,0
体会,2,2,0,2,0,0
讲,2,2,1,1,0,1
不堪,2,2,0,2,0,0
体谅,2,1,0,1,0,0
不够,2,1,1,1,1,0
拼命,2,2,1,1,0,1
害了,2,2,0,2,0,0
宠物,2,0,1,0,1,0
该,2,1,1,1,1,0
余生,2,0,1,0,1,0
看书,2,0,1,0,1,0
完美,2,2,0,2,0,0
一本,2,2,0,2,0,0
说出,2,2,0,2,0,0
存在,2,2,0,2,0,0
相同,2,2,1,1,0,1
说话,2,2,0,2,0,0
一晚上,2,2,1,1,0,1
一时冲动,2,1,1,1,1,0
你是谁,2,2,1,1,0,1
读,2,2,0,2,0,0
不太,2,2,0,2,0,0
学会,2,2,0,2,0,0
也曾,2,2,0,2,0,0
痛,2,1,1,1,1,0
谈恋爱,2,2,1,1,0,1
谩骂,2,2,0,2,0,0
负责,2,2,0,2,0,0
好想,2,2,0,2,0,0
不应该,2,2,0,2,0,0
起来,2,1,1,1,1,0
好好的,2,2,1,1,0,1
大概,2,0,1,0,1,0
生存,2,2,1,1,0,1
做什么,2,1,1,1,1,0
大事,2,1,1,1,1,0
生,2,2,0,2,0,0
多远,2,2,0,2,0,0
一堆,2,2,0,2,0,0
理想,2,2,1,1,0,1
一场,2,1,1,1,1,0
斯卡蒂,2,0,2,0,2,0
外地,2,2,0,2,0,0
新年,2,2,1,1,0,1
处境,2,2,1,1,0,1
还好吗,2,1,2,0,1,1
新闻,2,2,0,2,0,0
环境,2,2,0,2,0,0
还没,2,1,1,1,1,0
垃圾,2,2,0,2,0,0
一句,2,2,0,2,0,0
坚强,2,1,1,1,1,0
地球,2,1,1,1,1,0
猫,2,1,1,1,1,0
这个人,2,2,0,2,0,0
猝死,2,2,0,2,0,0
不敢死,2,2,0,2,0,0
在家,2,2,0,2,0,0
这么大,2,1,1,1,1,0
一些人,2,0,2,0,2,0
无力,2,1,1,1,1,0
生日,2,1,2,0,1,1
大理,2,2,2,0,0,2
做不到,2,1,0,1,0,0
路途,2,2,2,0,0,2
好多次,2,2,0,2,0,0
疫情,2,0,2,0,2,0
跑,2,1,1,1,1,0
搬家,2,2,1,1,0,1
住在,2,1,0,1,0,0
好久不见,2,1,2,0,1,1
距离,2,2,0,2,0,0
好久,2,1,1,1,1,0
好不好,2,0,2,0,2,0
她说,2,2,0,2,0,0
路,2,2,1,1,0,1
信息,2,0,0,0,0,0
摧毁,2,2,1,1,0,1
奇怪,2,2,0,2,0,0
天使,2,0,2,0,2,0
夺走,2,2,0,2,0,0
撕掉,2,2,0,2,0,0
画,2,2,1,1,0,1
踏上,2,1,1,1,1,0
倾诉,2,2,0,2,0,0
失业,2,2,0,2,0,0
太难,2,1,1,1,1,0
收入,2,2,0,2,0,0
躲,2,1,0,1,0,0
太累,2,1,1,1,1,0
电话,2,0,0,0,0,0
天气,2,1,2,0,1,1
放屁,2,2,0,2,0,0
拖,2,2,0,2,0,0
一点点,2,1,1,1,1,0
看起来,2,1,1,1,1,0
意识不到,2,2,0,2,0,0
等等,2,1,2,0,1,1
老婆,2,2,0,2,0,0
等着,2,0,2,0,2,0
感叹,2,1,1,1,1,0
考上,2,2,0,2,0,0
考虑,2,2,0,2,0,0
从小,2,2,0,2,0,0
很难,2,2,0,2,0,0
亲友,2,0,0,0,0,0
而是,2,2,0,2,0,0
感谢,2,1,1,1,1,0
愣了,2,2,1,1,0,1
耳,2,1,0,1,0,0
愤怒,2,2,0,2,0,0
很快,2,2,1,1,0,1
很强,2,2,0,2,0,0
聊天,2,2,0,2,0,0
亲,2,2,0,2,0,0
愿意,2,1,0,1,0,0
很好,2,2,0,2,0,0
很多次,2,2,0,2,0,0
他人,2,2,0,2,0,0
能不能,2,1,0,1,0,0
往,2,2,0,2,0,0
彼此,2,2,0,2,0,0
影响,2,1,0,1,0,0
立刻,2,0,0,0,0,0
立,2,0,2,0,2,0
他妈的,2,2,0,2,0,0
心中,2,0,0,0,0,0
意思,2,2,0,2,0,0
真,2,1,1,1,1,0
心智成熟,2,2,0,2,0,0
经常,2,1,1,1,1,0
什么时候,2,2,0,2,0,0
恶,2,2,1,1,0,1
什么是,2,2,0,2,0,0
恋爱,2,2,0,2,0,0
总有,2,1,2,0,1,1
总,2,2,0,2,0,0
上警,2,0,0,0,0,0
结果,2,1,1,1,1,0
绘,2,0,2,0,2,0
想办法,2,2,0,2,0,0
绝望,2,2,0,2,0,0
怎么玩,2,0,2,0,2,0
怎么样,2,2,0,2,0,0
想想,2,1,2,0,1,1
网上,2,1,2,0,1,1
念头,2,0,2,0,2,0
念,2,2,1,1,0,1
网瘾,2,2,0,2,0,0
网络暴力,2,2,1,1,0,1
下去,2,1,1,1,1,0
忍住,2,1,1,1,1,0
心软,2,2,1,1,0,1
羊,2,0,2,0,2,0
下来,2,2,1,1,0,1
心理,2,2,0,2,0,0
算是,2,2,1,1,0,1
人与人之间,2,2,0,2,0,0
美食,2,1,1,1,1,0
能看到,2,1,1,1,1,0
些,2,2,0,2,0,0
付出,2,2,0,2,0,0
三十岁,2,2,0,2,0,0
任由,2,1,1,1,1,0
居然,2,2,0,2,0,0
表面,2,2,0,2,0,0
瞬间,2,0,2,0,2,0
要不要,2,0,2,0,2,0
休息,2,2,2,0,0,2
抑郁,2,2,0,2,0,0
就好,2,1,1,1,1,0
要求,2,2,0,2,0,0
就可以,2,1,1,1,1,0
抑郁症,2,2,0,2,0,0
见到,2,1,1,1,1,0
尤其,2,2,0,2,0,0
尝试,2,1,1,0,0,1
抓,2,1,1,1,1,0
眼泪,2,1,0,1,0,0
小鸡,2,2,0,2,0,0
投胎,2,2,1,1,0,1
小朋友,2,0,1,0,1,0
会不会,2,0,2,0,2,0
小孩,2,2,0,2,0,0
角色,2,1,1,1,1,0
无奈,2,2,1,1,0,1
报复,2,0,2,0,2,0
不可估量,2,2,0,2,0,0
不同,2,2,0,2,0,0
抽烟,2,0,1,0,1,0
真名,2,0,0,0,0,0
低头,2,1,0,1,0,0
扔掉,2,2,0,2,0,0
争取,2,2,0,2,0,0
打电话,2,2,0,2,0,0
至少,2,0,2,0,2,0
强迫,2,1,1,1,1,0
脸,2,2,0,2,0,0
强,2,2,0,2,0,0
空间,2,2,1,1,0,1
空气,2,1,0,1,0,0
稳定,2,2,0,2,0,0
一顿,2,1,1,1,1,0
代价,2,2,0,2,0,0
建议,2,2,0,2,0,0
互相,2,2,1,1,0,1
神,2,1,2,0,1,1
至于,2,2,0,2,0,0
至今,2,1,1,1,1,0
舔,2,2,0,2,0,0
差,2,1,0,1,0,0
事件,2,2,1,1,0,1
苦,2,1,1,1,1,0
干涉,2,0,2,0,2,0
价值,2,1,1,1,1,0
干员,2,0,2,0,2,0
干,2,0,0,0,0,0
确实,2,2,0,2,0,0
荒诞,2,0,2,0,2,0
打击,2,1,1,1,1,0
不再,2,1,1,1,1,0
任何东西,2,0,1,0,1,0
打气,2,2,2,0,0,2
差点,2,2,1,1,0,1
这件事,2,2,1,1,0,1
身上,2,2,0,2,0,0
动态,2,0,2,0,2,0
不然,2,1,0,1,0,0
变成,2,1,1,1,1,0
不管是,2,1,1,1,1,0
quot,2,2,0,2,0,0
风,2,1,1,0,0,1
明白,2,1,2,0,1,1
道理,2,2,0,2,0,0
沉迷,2,0,0,0,0,0
极端,2,2,0,2,0,0
剪断,2,2,0,2,0,0
期待,2,1,1,1,1,0
极大,2,2,0,2,0,0
烦恼,2,1,2,0,1,1
顺其自然,2,1,1,1,1,0
ID,2,0,1,0,1,0
面试,2,2,0,2,0,0
动力,2,2,1,1,0,1
句,2,2,0,2,0,0
没事,2,1,1,1,1,0
听话,2,1,1,1,1,0
明明,2,1,1,1,1,0
再买,2,0,2,0,2,0
遇到,2,2,1,1,0,1
不认识,2,1,1,1,1,0
爱好,2,2,0,2,0,0
’,2,2,2,0,0,2
丧,2,2,2,0,0,2
不死,2,0,2,0,2,0
样子,2,1,1,1,1,0
随便,2,2,0,2,0,0
这几天,2,0,2,0,2,0
刮子,2,1,0,1,0,0
和解,2,2,1,1,0,1
决绝,2,0,1,0,1,0
‘,2,2,2,0,0,2
没用,2,2,0,2,0,0
呐,2,2,1,1,0,1
变得,2,2,0,2,0,0
刹,2,0,0,0,0,0
逼迫,2,2,0,2,0,0
冲动,2,1,1,1,1,0
后辈,2,1,1,1,1,0
不许,2,2,0,2,0,0
司机,2,2,0,2,0,0
不说,2,2,0,2,0,0
满足,2,2,0,2,0,0
可爱,2,2,1,1,0,1
共同话题,2,1,1,1,1,0
可惜,2,1,1,1,1,0
可悲,2,1,1,1,1,0
机制,2,2,0,2,0,0
没必要,2,2,0,2,0,0
不管怎样,2,2,1,1,0,1
千万别,2,1,1,1,1,0
本身,2,2,0,2,0,0
酗酒,2,1,0,1,0,0
单位,2,1,0,1,0,0
本质,2,2,0,2,0,0
只能,2,1,1,1,1,0
不疼,2,2,0,2,0,0
本来,2,1,2,0,1,1
重复,2,1,0,1,0,0
医院,2,0,1,0,1,0
后悔,2,2,0,2,0,0
权利,2,2,0,2,0,0
没什么,2,2,0,2,0,0
同样,2,2,0,2,0,0
同情,2,2,0,2,0,0
没有用,2,2,0,2,0,0
没有必要,2,0,2,0,2,0
只不过,2,1,1,1,1,0
晚,2,1,1,1,1,0
没关系,2,2,0,2,0,0
靠,2,1,1,1,1,0
没办法,2,2,0,2,0,0
清理,2,1,1,1,1,0
那样,2,1,1,1,1,0
只想,2,2,0,2,0,0
各位,2,1,0,1,0,0
吃饭,2,2,1,1,0,1
普通人,2,2,0,2,0,0
包袱,2,2,0,2,0,0
时,2,1,0,1,0,0
首页,2,0,1,0,1,0
逃避,2,2,0,2,0,0
有种,2,1,1,1,1,0
内容,2,0,0,0,0,0
进度,2,0,0,0,0,0
准备,2,2,1,1,0,1
物理,2,2,0,2,0,0
闺蜜,2,2,0,2,0,0
嘴里,2,1,1,1,1,0
鸿沟,2,2,0,2,0,0
有的时候,2,2,0,2,0,0
嘴,2,0,1,0,1,0
凉了,2,1,2,0,1,1
泼,2,2,0,2,0,0
迟早,2,1,1,1,1,0
既然,2,2,1,1,0,1
早点,2,1,0,1,0,0
长期,2,2,0,2,0,0
日出,2,0,2,0,2,0
发出去,2,1,2,0,1,1
-,2,2,0,2,0,0
像,2,1,2,0,1,1
反思,2,1,1,1,1,0
儿,2,0,2,0,2,0
又有,2,2,0,2,0,0
有时候,2,2,0,2,0,0
困难,2,1,2,0,1,1
闭嘴,2,1,0,1,0,0
世上,2,0,2,0,2,0
闭上,2,1,0,1,0,0
??,2,1,2,0,1,1
这样做,2,1,1,1,1,0
  大约,2,2,0,2,0,0
一丝丝,2,2,1,1,0,1
有意思,2,1,1,1,1,0
?,2,2,2,0,0,2
这次,2,1,0,1,0,0
一下子,2,1,1,1,1,0
凭什么,2,2,0,2,0,0
有点,2,1,2,0,1,1
洗脑,2,2,0,2,0,0
这边,2,1,1,0,0,1
去年,2,2,1,1,0,1
爸爸妈妈,2,1,1,1,1,0
中国,2,2,0,2,0,0
长大,2,2,0,2,0,0
送走,2,2,0,2,0,0
活成,2,2,0,2,0,0
次,2,2,0,2,0,0
送给,2,1,2,0,1,1
原,2,2,2,0,0,2
啃老,2,2,0,2,0,0
儿女,2,0,1,0,1,0
不行,2,0,1,0,1,0
再也,2,2,0,2,0,0
喊,2,2,0,2,0,0
爷,2,2,0,2,0,0
有些人,2,0,1,0,1,0
哭着,2,2,0,2,0,0
逃,2,2,2,0,0,2
逃出,2,2,0,2,0,0
比较好,2,1,1,1,1,0
消息,2,1,1,1,1,0
善良,2,2,0,2,0,0
养活,2,2,0,2,0,0
本人,2,0,0,0,0,0
错,2,1,1,0,0,1
爸爸,2,2,0,2,0,0
喜不,2,0,2,0,2,0
早,2,2,0,2,0,0
有问题,2,1,1,1,1,0
社畜,1,1,0,1,0,0
积,1,0,0,0,0,0
称为,1,1,0,1,0,0
碰,1,0,1,0,1,0
稍稍,1,1,1,0,0,1
碰上,1,1,0,1,0,0
没钱,1,1,0,1,0,0
社会活,1,1,0,1,0,0
磨刀,1,1,0,1,0,0
泪目,1,1,0,1,0,0
礼物,1,0,1,0,1,0
碍着,1,1,0,1,0,0
祸害,1,0,0,0,0,0
神经病,1,1,0,1,0,0
稍微,1,1,0,1,0,0
不会死,1,1,0,1,0,0
不上,1,0,1,0,1,0
祝好,1,1,0,1,0,0
不一样,1,1,0,1,0,0
没法,1,1,0,1,0,0
砸碎,1,0,1,0,1,0
秋叶原,1,1,0,1,0,0
离去,1,0,1,0,1,0
砸烂,1,1,0,1,0,0
不仅,1,1,0,1,0,0
洒脱,1,1,0,1,0,0
硬撑,1,1,0,1,0,0
离世,1,1,1,0,0,1
没有精神支柱,1,0,1,0,1,0
破防,1,1,0,1,0,0
沾沾自喜,1,1,0,1,0,0
破茧成蝶,1,1,0,1,0,0
没有人,1,1,0,1,0,0
祝福你,1,1,1,0,0,1
没有耐性,1,1,0,1,0,0
狗,1,0,1,0,1,0
稻草,1,1,1,0,0,1
毒害,1,0,0,0,0,0
糟心事,1,1,0,1,0,0
糊糊,1,0,1,0,1,0
下午,1,1,1,0,0,1
每次,1,1,0,1,0,0
毒,1,1,0,1,0,0
精神寄托,1,1,0,1,0,0
下半夜,1,1,1,0,0,1
精气,1,0,1,0,1,0
每天早上,1,1,1,0,0,1
粗心大意,1,1,0,1,0,0
毒鸡汤,1,0,0,0,0,0
粉,1,1,0,1,0,0
下意识,1,1,0,1,0,0
籍籍无名,1,1,0,1,0,0
比如,1,1,0,1,0,0
箱,1,1,0,1,0,0
每年,1,0,1,0,1,0
每天,1,0,1,0,1,0
管控,1,1,1,0,0,1
毁灭掉,1,1,0,1,0,0
细心,1,1,0,1,0,0
组团,1,0,1,0,1,0
纸片,1,0,1,0,1,0
纠结,1,0,1,0,1,0
毁,1,0,1,0,1,0
絮叨,1,1,0,1,0,0
累了,1,1,0,1,0,0
母亲,1,1,0,1,0,0
系列,1,1,1,0,0,1
紧迫,1,0,0,0,0,0
紧跟,1,1,1,0,0,1
每,1,1,0,1,0,0
索尼,1,0,1,0,1,0
每个,1,1,0,1,0,0
不要再说,1,1,0,1,0,0
素不相识,1,1,0,1,0,0
比起,1,1,0,1,0,0
比较凶,1,1,0,1,0,0
没想到,1,1,0,1,0,0
站着说话不腰疼,1,0,0,0,0,0
第一次,1,1,0,1,0,0
第一支,1,0,1,0,1,0
第一批,1,1,0,1,0,0
第一天,1,1,0,1,0,0
笨蛋,1,0,1,0,1,0
笑,1,0,1,0,1,0
端午,1,0,1,0,1,0
站,1,1,0,1,0,0
破脸,1,1,0,1,0,0
立场,1,0,1,0,1,0
没多久,1,1,1,0,0,1
窗外,1,1,0,1,0,0
窒息感,1,1,0,1,0,0
没完没了,1,0,1,0,1,0
没情商,1,0,0,0,0,0
穿什么,1,1,0,1,0,0
第一眼,1,0,1,0,1,0
没了,1,1,1,0,0,1
毕竟,1,1,0,1,0,0
不舍,1,1,0,1,0,0
毫无,1,1,0,1,0,0
算什么,1,0,1,0,1,0
下楼,1,0,1,0,1,0
简单,1,1,1,0,0,1
氛围,1,1,0,1,0,0
水  ,1,1,0,1,0,0
永世,1,1,1,0,0,1
永远不会,1,1,0,1,0,0
沙雕,1,0,1,0,1,0
求死,1,1,0,1,0,0
第二天,1,1,1,0,0,1
第二,1,0,1,0,1,0
求生,1,0,1,0,1,0
第三封,1,1,0,1,0,0
江苏,1,0,0,0,0,0
第三周,1,1,0,1,0,0
洗脚,1,0,0,0,0,0
不受,1,1,0,1,0,0
破坏,1,1,0,1,0,0
由,1,1,1,0,0,1
照旧,1,1,0,1,0,0
留恋,1,1,0,1,0,0
照样,1,1,0,1,0,0
留念,1,1,1,0,0,1
照顾,1,0,1,0,1,0
熟悉,1,1,1,0,0,1
爬,1,1,0,1,0,0
留在,1,1,0,1,0,0
留下,1,1,0,1,0,0
界限,1,1,0,1,0,0
界,1,0,1,0,1,0
男性,1,0,0,0,0,0
终,1,0,1,0,1,0
爱情,1,1,0,1,0,0
男孩,1,1,0,1,0,0
男女,1,0,0,0,0,0
不正常,1,1,0,1,0,0
男人,1,0,0,0,0,0
不开心,1,1,0,1,0,0
不死心,1,0,1,0,1,0
不满,1,1,0,1,0,0
番茄鸡蛋面,1,1,0,1,0,0
癌细胞,1,0,1,0,1,0
的   ,1,1,0,1,0,0
不爱说话,1,1,0,1,0,0
点个赞,1,1,0,1,0,0
点缀,1,1,1,0,0,1
白眼狼,1,0,1,0,1,0
白白,1,0,1,0,1,0
烦,1,1,0,1,0,0
白天,1,1,0,1,0,0
癌症,1,1,0,1,0,0
疯了,1,1,0,1,0,0
烧掉,1,0,0,0,0,0
不少,1,0,1,0,1,0
热情,1,1,0,1,0,0
痛感,1,1,0,1,0,0
病了,1,0,1,0,1,0
疼,1,1,0,1,0,0
疲惫,1,1,0,1,0,0
疯狂,1,1,0,1,0,0
由头,1,0,0,0,0,0
田字格,1,1,0,1,0,0
盆栽,1,1,0,1,0,0
甩掉,1,1,0,1,0,0
物质,1,1,0,1,0,0
环,1,1,1,0,0,1
玩转,1,1,0,1,0,0
玩玩,1,0,1,0,1,0
牵绊,1,1,0,1,0,0
特么的,1,0,0,0,0,0
不明,1,1,0,1,0,0
玩亏,1,0,1,0,1,0
王卡组,1,1,0,1,0,0
猫猫,1,0,1,0,1,0
特定,1,1,0,1,0,0
牺牲,1,0,1,0,1,0
独自离去,1,1,0,1,0,0
独自,1,1,0,1,0,0
犯,1,0,0,0,0,0
狠心,1,1,0,1,0,0
犯法,1,1,0,1,0,0
状况,1,0,1,0,1,0
狗狗,1,0,1,0,1,0
不救,1,1,0,1,0,0
不懂事,1,1,0,1,0,0
现实中,1,1,0,1,0,0
生前,1,0,1,0,1,0
不当,1,1,1,0,0,1
生气,1,1,0,1,0,0
生死,1,0,1,0,1,0
生日快乐,1,0,1,0,1,0
生成,1,0,1,0,1,0
不期而遇,1,1,0,1,0,0
不怕临死,1,0,1,0,1,0
不想听,1,1,0,1,0,0
不愿,1,0,1,0,1,0
物件,1,1,0,1,0,0
瓶颈,1,1,0,1,0,0
瓢泼大雨,1,1,1,0,0,1
不懂,1,0,1,0,1,0
理发,1,0,1,0,1,0
爽,1,0,1,0,1,0
班主任,1,1,1,0,0,1
珍视,1,1,0,1,0,0
珍爱,1,0,0,0,0,0
的是,1,1,0,1,0,0
炉子,1,1,0,1,0,0
矿,1,1,0,1,0,0
不回家,1,1,0,1,0,0
眼,1,1,0,1,0,0
流眼泪,1,0,1,0,1,0
浊,1,0,1,0,1,0
真谛,1,1,0,1,0,0
消极,1,1,0,1,0,0
消磨,1,1,0,1,0,0
真相,1,1,0,1,0,0
真的能够,1,1,0,1,0,0
消逝,1,0,1,0,1,0
真的有,1,0,1,0,1,0
不可,1,0,1,0,1,0
不可能,1,1,0,1,0,0
真心话,1,1,0,1,0,0
涨停板,1,0,1,0,1,0
不和,1,1,0,1,0,0
不哭,1,1,0,1,0,0
淌出,1,1,0,1,0,0
真假,1,0,0,0,0,0
深呼吸,1,0,1,0,1,0
眼前,1,1,0,1,0,0
活路,1,1,0,1,0,0
眼睛,1,1,0,1,0,0
睡不着,1,1,0,1,0,0
石头,1,1,0,1,0,0
短暂,1,0,1,0,1,0
知道吗,1,0,1,0,1,0
不准,1,1,0,1,0,0
矣,1,1,0,1,0,0
矛盾,1,0,1,0,1,0
睡死,1,1,0,1,0,0
睡前,1,1,0,1,0,0
不分,1,0,1,0,1,0
不痛不痒,1,0,1,0,1,0
睁眼,1,1,1,0,0,1
着魔,1,1,0,1,0,0
着墨,1,0,0,0,0,0
不知,1,1,0,1,0,0
不着急,1,0,1,0,1,0
活人,1,1,0,1,0,0
活出,1,1,0,1,0,0
活动彩六,1,0,1,0,1,0
深夜,1,1,0,1,0,0
深有感触,1,0,1,0,1,0
灾难,1,1,0,1,0,0
不在乎,1,1,0,1,0,0
滴,1,1,0,1,0,0
滴滴打车,1,1,0,1,0,0
漂亮,1,0,1,0,1,0
相信自己,1,1,0,1,0,0
演唱会,1,1,0,1,0,0
相似,1,1,0,1,0,0
相亲不去,1,0,1,0,1,0
漫画,1,1,0,1,0,0
不如,1,1,0,1,0,0
漫长,1,1,1,0,0,1
不孝,1,0,0,0,0,0
潭水,1,1,0,1,0,0
不畏惧,1,0,1,0,1,0
目睹,1,1,1,0,0,1
灵魂,1,1,1,0,0,1
目的,1,0,1,0,1,0
目标,1,1,0,1,0,0
目前,1,1,0,1,0,0
监狱,1,1,1,0,0,1
相处,1,1,0,1,0,0
相对,1,1,0,1,0,0
相欠,1,0,1,0,1,0
游,1,0,1,0,1,0
深渊,1,1,0,1,0,0
看看风景,1,0,1,0,1,0
看清楚,1,0,1,0,1,0
看机会,1,1,0,1,0,0
渗,1,1,1,0,0,1
不堪一击,1,0,1,0,1,0
温暖,1,1,0,1,0,0
港湾,1,1,0,1,0,0
看哭,1,1,0,1,0,0
满腔热血,1,1,0,1,0,0
不大,1,0,1,0,1,0
看出,1,1,1,0,0,1
游离,1,1,1,0,0,1
游魂,1,0,1,0,1,0
看不顺眼,1,1,0,1,0,0
源泉,1,1,0,1,0,0
看不起,1,1,0,1,0,0
看不到,1,1,0,1,0,0
细致,1,1,0,1,0,0
几个,1,0,0,0,0,0
终于,1,1,0,1,0,0
这只,1,0,1,0,1,0
透过,1,1,0,1,0,0
选择权,1,1,0,1,0,0
选好,1,0,1,0,1,0
逃避现实,1,0,1,0,1,0
逃走,1,0,1,0,1,0
逃出来,1,1,0,1,0,0
适合,1,1,0,1,0,0
送饭,1,0,1,0,1,0
送,1,0,1,0,1,0
退缩,1,0,1,0,1,0
退坑,1,0,1,0,1,0
追求,1,1,1,0,0,1
追星,1,1,0,1,0,0
追,1,1,0,1,0,0
迟迟,1,0,1,0,1,0
「,1,0,1,0,1,0
远远,1,0,1,0,1,0
」,1,0,1,0,1,0
进行,1,0,0,0,0,0
进去,1,1,0,1,0,0
进,1,0,1,0,1,0
一万次,1,1,0,1,0,0
这辈子,1,1,0,1,0,0
这样的人,1,0,1,0,1,0
一两次,1,1,0,1,0,0
途中,1,1,0,1,0,0
通知,1,1,0,1,0,0
通过,1,0,1,0,1,0
遵循,1,0,1,0,1,0
cp,1,1,1,0,0,1
emo,1,1,0,1,0,0
live,1,0,1,0,1,0
那条,1,1,0,1,0,0
那天,1,1,1,0,0,1
那只,1,1,0,1,0,0
那位,1,0,0,0,0,0
orz,1,0,1,0,1,0
pg,1,0,1,0,1,0
那个时候,1,1,0,1,0,0
避免,1,1,0,1,0,0
遵从,1,1,0,1,0,0
逛,1,1,0,1,0,0
遭遇,1,1,0,1,0,0
遥远,1,1,1,0,0,1
遗言,1,1,0,1,0,0
ps4,1,0,1,0,1,0
遗忘,1,1,0,1,0,0
pua,1,1,0,1,0,0
道歉,1,1,0,1,0,0
遇见,1,1,1,0,0,1
逼疯,1,0,1,0,1,0
sha,1,0,1,0,1,0
造成,1,1,0,1,0,0
一两顿,1,1,0,1,0,0
一个把,1,0,0,0,0,0
部分,1,1,0,1,0,0
一个月,1,1,0,1,0,0
过分,1,1,0,1,0,0
过几天,1,0,1,0,1,0
过下去,1,1,0,1,0,0
一大堆,1,0,1,0,1,0
一大把,1,0,0,0,0,0
一大早,1,0,0,0,0,0
辛苦,1,0,1,0,1,0
辗转,1,1,1,0,0,1
辆,1,1,0,1,0,0
较劲,1,0,1,0,1,0
轻飘飘,1,1,0,1,0,0
轻视,1,0,0,0,0,0
轻易,1,0,1,0,1,0
轻描淡写,1,1,0,1,0,0
软弱,1,0,0,0,0,0
轮不到,1,1,0,1,0,0
转头,1,1,0,1,0,0
转出来,1,0,1,0,1,0
轨迹,1,0,1,0,1,0
车票,1,1,0,1,0,0
车,1,1,0,1,0,0
躺,1,1,0,1,0,0
躲不过,1,0,1,0,1,0
身体,1,0,1,0,1,0
身份证号,1,0,0,0,0,0
一声,1,0,1,0,1,0
过往,1,0,1,0,1,0
过百万,1,1,0,1,0,0
一半帮,1,0,1,0,1,0
这代人,1,1,0,1,0,0
这些天,1,0,1,0,1,0
这么多年,1,0,1,0,1,0
一件,1,0,1,0,1,0
一份,1,0,1,0,1,0
这个时候,1,1,0,1,0,0
这个家,1,0,1,0,1,0
一千次,1,1,0,1,0,0
这两天,1,1,0,1,0,0
这一篇,1,1,0,1,0,0
这一年,1,1,0,1,0,0
还给,1,0,1,0,1,0
过错,1,0,1,0,1,0
还没有,1,1,0,1,0,0
一只,1,1,0,1,0,0
一同,1,0,1,0,1,0
还小,1,1,0,1,0,0
一名,1,1,1,0,0,1
一周,1,1,0,1,0,0
一团乱麻,1,1,0,1,0,0
还不错,1,1,1,0,0,1
近十年,1,1,0,1,0,0
运转,1,1,0,1,0,0
迎接,1,0,1,0,1,0
邪恶,1,1,0,1,0,0
cod,1,0,1,0,1,0
终点,1,1,0,1,0,0
难得糊涂,1,1,1,0,0,1
食粮,1,1,0,1,0,0
飞天,1,0,0,0,0,0
风花雪月,1,1,1,0,0,1
风暴,1,1,0,1,0,0
颠倒黑白,1,1,0,1,0,0
领导,1,0,1,0,1,0
预,1,1,0,1,0,0
24岁,1,1,0,1,0,0
顺便,1,1,0,1,0,0
鞋,1,0,0,0,0,0
25,1,1,0,1,0,0
面子,1,0,1,0,1,0
面前,1,0,1,0,1,0
面,1,1,0,1,0,0
靠山,1,1,0,1,0,0
25岁,1,0,0,0,0,0
非得,1,1,0,1,0,0
2d,1,0,1,0,1,0
青年,1,1,0,1,0,0
3个月,1,0,1,0,1,0
集美,1,0,1,0,1,0
集团,1,0,0,0,0,0
集,1,0,0,0,0,0
难道,1,0,1,0,1,0
521,1,0,1,0,1,0
饭桌,1,1,0,1,0,0
饭碗,1,1,0,1,0,0
饿,1,1,0,1,0,0
高高在上,1,1,0,1,0,0
?,1,1,0,1,0,0
黑碟,1,0,1,0,1,0
黄,1,1,0,1,0,0
麻麻,1,1,0,1,0,0
',1,1,1,0,0,1
麻木,1,1,0,1,0,0
鹿道森,1,0,1,0,1,0
鸭,1,0,1,0,1,0
鸣不平,1,1,0,1,0,0
鱼死网破,1,0,1,0,1,0
鱼,1,0,0,0,0,0
高达,1,0,1,0,1,0
首先,1,1,0,1,0,0
高兴吗,1,1,0,1,0,0
高兴,1,1,0,1,0,0
17岁,1,1,0,1,0,0
高下,1,1,0,1,0,0
高,1,1,0,1,0,0
骗回去,1,1,0,1,0,0
骆驼,1,1,1,0,0,1
19年初,1,0,1,0,1,0
驱,1,1,1,0,0,1
20多年,1,0,0,0,0,0
香港,1,0,0,0,0,0
难念的经,1,0,0,0,0,0
难听,1,1,0,1,0,0
apex,1,0,1,0,1,0
5个,1,1,1,0,0,1
锅,1,1,0,1,0,0
销号,1,1,0,1,0,0
铺子,1,1,1,0,0,1
银行卡,1,1,0,1,0,0
铁管,1,1,0,1,0,0
铁圈,1,1,0,1,0,0
钱物,1,1,1,0,0,1
DAYTOY,1,0,0,0,0,0
钥匙,1,1,0,1,0,0
金枪鱼,1,1,0,1,0,0
金弦5,1,1,0,1,0,0
重获新生,1,1,1,0,0,1
重男轻女,1,1,0,1,0,0
重新,1,1,0,1,0,0
重拳,1,0,1,0,1,0
重开,1,1,0,1,0,0
重度,1,1,0,1,0,0
重叠,1,1,0,1,0,0
XX,1,1,0,1,0,0
X玖少年团,1,0,0,0,0,0
醒醒,1,0,1,0,1,0
amp,1,0,1,0,1,0
醒悟,1,1,0,1,0,0
醒了,1,1,0,1,0,0
配,1,1,0,1,0,0
错误,1,1,0,1,0,0
错过,1,0,1,0,1,0
长亭,1,1,0,1,0,0
阴阳怪气,1,1,1,0,0,1
难以割舍,1,1,0,1,0,0
7.8年前,1,1,0,1,0,0
隐隐约约,1,1,1,0,0,1
隐藏,1,1,1,0,0,1
随着,1,0,0,0,0,0
随意,1,1,0,1,0,0
随心所欲,1,1,0,1,0,0
陪,1,0,1,0,1,0
70年代初,1,1,0,1,0,0
80后,1,0,1,0,1,0
阿里,1,0,1,0,1,0
阴谋,1,0,0,0,0,0
长大后,1,1,0,1,0,0
阳光,1,1,0,1,0,0
队伍,1,1,1,0,0,1
阅历,1,0,1,0,1,0
闹,1,0,0,0,0,0
间,1,0,0,0,0,0
闲起来,1,1,1,0,0,1
闲,1,0,0,0,0,0
问,1,1,0,1,0,0
闭眼,1,1,1,0,0,1
长辈,1,1,0,1,0,0
长眠,1,1,1,0,0,1
身份,1,0,1,0,1,0
践踏,1,1,0,1,0,0
跳舞,1,0,1,0,1,0
背后,1,0,1,0,1,0
自私  ,1,1,0,1,0,0
死罪,1,1,0,1,0,0
一部分,1,1,1,0,0,1
一间,1,1,1,0,0,1
自救行为,1,1,0,1,0,0
自救,1,1,0,1,0,0
自打,1,1,0,1,0,0
自我攻击,1,0,1,0,1,0
自我感动,1,1,0,1,0,0
一顿别去,1,1,0,1,0,0
一颤,1,1,0,1,0,0
自刎,1,1,0,1,0,0
自以为是,1,1,0,1,0,0
万分之一,1,0,0,0,0,0
腹背受敌,1,1,0,1,0,0
腐蚀,1,0,1,0,1,0
腆着,1,1,0,1,0,0
脑子,1,0,0,0,0,0
能看见,1,1,0,1,0,0
能用,1,1,0,1,0,0
能有,1,1,0,1,0,0
三国志,1,1,0,1,0,0
三年,1,1,1,0,0,1
能做,1,1,1,0,0,1
胸有不平意,1,1,0,1,0,0
自私鬼,1,1,0,1,0,0
自立,1,0,0,0,0,0
自食其力,1,1,0,1,0,0
苦苦相逼,1,1,0,1,0,0
蛮不讲理,1,1,0,1,0,0
蛮,1,1,0,1,0,0
一走了之,1,1,0,1,0,0
藏起来,1,0,1,0,1,0
蔑视,1,0,0,0,0,0
营造,1,1,0,1,0,0
菠萝面包,1,1,1,0,0,1
莽,1,1,0,1,0,0
一起玩,1,0,1,0,1,0
莫名其妙,1,1,0,1,0,0
范本,1,1,0,1,0,0
苦恼,1,1,0,1,0,0
臭,1,0,0,0,0,0
苟且,1,1,0,1,0,0
一路走好,1,1,1,0,0,1
花花草草,1,1,0,1,0,0
花花,1,1,0,1,0,0
一转眼,1,1,0,1,0,0
芭比娃娃,1,1,0,1,0,0
艰难,1,1,0,1,0,0
舍得,1,0,1,0,1,0
舍不得,1,1,0,1,0,0
舆论压力,1,1,0,1,0,0
臭骂,1,1,0,1,0,0
背着,1,1,0,1,0,0
三月,1,1,0,1,0,0
跳河,1,1,0,1,0,0
肮脏,1,0,1,0,1,0
置顶,1,0,1,0,1,0
罪大恶极,1,1,0,1,0,0
罢休,1,0,1,0,1,0
罢,1,1,1,0,0,1
网警,1,0,0,0,0,0
网络,1,0,1,0,1,0
网线,1,1,0,1,0,0
网名,1,1,0,1,0,0
上海,1,0,1,0,1,0
缘分,1,1,0,1,0,0
编辑,1,0,1,0,1,0
缓过来,1,1,0,1,0,0
上网,1,0,1,0,1,0
绝路,1,0,1,0,1,0
绝对,1,1,0,1,0,0
给予,1,1,0,1,0,0
结束生命,1,1,0,1,0,0
结局,1,1,0,1,0,0
上述,1,0,0,0,0,0
结,1,1,0,1,0,0
经过,1,1,0,1,0,0
经历过,1,1,0,1,0,0
下一次,1,1,0,1,0,0
经不起,1,1,0,1,0,0
终究,1,1,1,0,0,1
美,1,0,1,0,1,0
美丽,1,1,0,1,0,0
上气不接下气,1,1,0,1,0,0
上半夜,1,1,1,0,0,1
肚子,1,1,0,1,0,0
三点,1,1,0,1,0,0
肆意,1,1,0,1,0,0
聚,1,1,0,1,0,0
上下班,1,1,0,1,0,0
联动,1,0,1,0,1,0
耽误,1,1,0,1,0,0
耶活下去,1,0,1,0,1,0
而远之,1,0,1,0,1,0
而死,1,1,0,1,0,0
上个月,1,1,0,1,0,0
上吊,1,0,1,0,1,0
美满,1,1,0,1,0,0
考察,1,1,0,1,0,0
考,1,1,0,1,0,0
老鼠,1,0,0,0,0,0
老师,1,1,0,1,0,0
老公,1,0,1,0,1,0
翻翻,1,1,0,1,0,0
上来,1,0,0,0,0,0
翅膀,1,1,0,1,0,0
群星,1,1,1,0,0,1
上次,1,1,1,0,0,1
美食up,1,0,1,0,1,0
螺旋,1,0,0,0,0,0
蟑螂,1,0,0,0,0,0
血亲,1,1,0,1,0,0
行为,1,1,0,1,0,0
赖以,1,1,1,0,0,1
赖,1,1,0,1,0,0
资格,1,1,0,1,0,0
贵,1,1,0,1,0,0
贴心,1,1,0,1,0,0
贴,1,1,0,1,0,0
贬低,1,1,0,1,0,0
货真价实,1,0,1,0,1,0
账号,1,0,1,0,1,0
败给,1,1,1,0,0,1
责骂,1,1,0,1,0,0
责怪,1,0,0,0,0,0
责备,1,1,0,1,0,0
贡献,1,1,0,1,0,0
谢谢,1,0,1,0,1,0
谈,1,1,0,1,0,0
谁知道,1,0,0,0,0,0
一时,1,1,0,1,0,0
读博,1,1,0,1,0,0
请问,1,0,0,0,0,0
说教,1,0,1,0,1,0
说出来,1,1,0,1,0,0
一期一祈,1,0,1,0,1,0
说事儿,1,0,1,0,1,0
说了算,1,1,0,1,0,0
赖赖,1,0,0,0,0,0
一旦,1,0,1,0,1,0
一无所有,1,1,0,1,0,0
越来越少,1,0,0,0,0,0
跳楼  ,1,1,0,1,0,0
一套,1,1,0,1,0,0
跳下去,1,1,0,1,0,0
跳,1,1,0,1,0,0
路上,1,1,0,1,0,0
跨,1,1,0,1,0,0
跟着,1,1,0,1,0,0
跑来,1,1,1,0,0,1
跑去,1,1,0,1,0,0
一家,1,1,1,0,0,1
越界,1,1,0,1,0,0
越来越,1,1,0,1,0,0
赞颂,1,1,0,1,0,0
超,1,1,0,1,0,0
起风,1,1,1,0,0,1
起色,1,1,0,1,0,0
起床,1,0,1,0,1,0
一年,1,1,0,1,0,0
赶上,1,0,1,0,1,0
走好,1,0,1,0,1,0
走前,1,0,1,0,1,0
一摸,1,1,0,1,0,0
走上,1,1,1,0,0,1
一整天,1,1,0,1,0,0
说一下,1,1,0,1,0,0
误解,1,1,0,1,0,0
该怎么办,1,1,0,1,0,0
装理中客,1,0,0,0,0,0
解决,1,0,1,0,1,0
角度,1,1,0,1,0,0
觉醒,1,1,0,1,0,0
一生,1,1,0,1,0,0
视而不见,1,1,0,1,0,0
观念,1,1,0,1,0,0
见过,1,0,0,0,0,0
见识,1,1,0,1,0,0
一生埋怨,1,0,0,0,0,0
要死,1,1,0,1,0,0
一生顺遂,1,0,1,0,1,0
装死,1,0,0,0,0,0
解压,1,1,0,1,0,0
裁决,1,1,0,1,0,0
被骂,1,1,0,1,0,0
被逼无奈,1,1,0,1,0,0
被抢,1,1,1,0,0,1
被子,1,1,0,1,0,0
一看,1,0,0,0,0,0
补,1,0,1,0,1,0
衣服,1,1,0,1,0,0
行进,1,0,1,0,1,0
行李箱,1,1,0,1,0,0
行吗,1,0,0,0,0,0
解决问题,1,1,0,1,0,0
言语,1,1,0,1,0,0
话题,1,1,0,1,0,0
训斥,1,1,0,1,0,0
诚然,1,0,0,0,0,0
试过,1,1,1,0,0,1
试着,1,0,1,0,1,0
试图,1,0,0,0,0,0
诉苦,1,1,0,1,0,0
一朵云,1,1,0,1,0,0
一条,1,1,0,1,0,0
许多许多,1,0,1,0,1,0
记忆犹新,1,1,0,1,0,0
记忆,1,1,0,1,0,0
一根,1,1,1,0,0,1
让人,1,0,1,0,1,0
警,1,1,1,0,0,1
讨论,1,1,0,1,0,0
认错,1,1,0,1,0,0
一模一样,1,0,1,0,1,0
认命,1,1,0,1,0,0
认同,1,1,0,1,0,0
认可,1,0,1,0,1,0
一滴,1,0,0,0,0,0
认,1,0,1,0,1,0
计划,1,1,0,1,0,0
警方,1,0,0,0,0,0
一点儿,1,1,0,1,0,0
一辈,1,1,0,1,0,0
是死是活,1,1,0,1,0,0
死磕,1,1,1,0,0,1
好快,1,0,1,0,1,0
佩服,1,1,0,1,0,0
妈,1,1,0,1,0,0
如释重负,1,1,0,1,0,0
如愿,1,1,0,1,0,0
如何,1,0,1,0,1,0
好转,1,1,0,1,0,0
好累,1,1,1,0,0,1
好看,1,0,1,0,1,0
依着,1,1,0,1,0,0
好歹,1,1,0,1,0,0
好日子,1,0,1,0,1,0
好惨,1,1,0,1,0,0
好心人,1,0,0,0,0,0
信任,1,1,0,1,0,0
好心,1,0,1,0,1,0
好小,1,1,1,0,0,1
好好努力,1,1,1,0,0,1
依靠,1,1,0,1,0,0
好大,1,1,1,0,0,1
保不住,1,1,0,1,0,0
保平安,1,1,1,0,0,1
好几年,1,1,0,1,0,0
保护,1,1,0,1,0,0
好么,1,1,0,1,0,0
好久不来,1,1,0,1,0,0
保持,1,1,0,1,0,0
妖魔鬼怪,1,1,0,1,0,0
妨碍,1,0,1,0,1,0
妹子,1,1,0,1,0,0
妻子,1,1,0,1,0,0
安息,1,0,1,0,1,0
安康,1,0,1,0,1,0
作用,1,1,0,1,0,0
安乐死,1,1,0,1,0,0
你的错,1,1,0,1,0,0
学生时代,1,1,1,0,0,1
学校,1,1,0,1,0,0
学成,1,1,0,1,0,0
学到,1,0,1,0,1,0
学不会,1,1,1,0,0,1
孤立无援,1,1,0,1,0,0
孤注一掷,1,1,0,1,0,0
孝,1,1,0,1,0,0
存钱,1,1,0,1,0,0
存档,1,0,1,0,1,0
存,1,0,1,0,1,0
字,1,1,0,1,0,0
嫖娼,1,0,0,0,0,0
婚生,1,1,0,1,0,0
婚恋至上,1,1,0,1,0,0
婚恋,1,1,0,1,0,0
婚嫁,1,0,0,0,0,0
婚姻,1,1,0,1,0,0
你自己,1,0,1,0,1,0
你自由了,1,0,1,0,1,0
她自己,1,1,0,1,0,0
女生,1,0,1,0,1,0
做完,1,1,0,1,0,0
多么,1,0,1,0,1,0
大妈,1,1,0,1,0,0
大多,1,1,0,1,0,0
大叔,1,1,0,1,0,0
做决定,1,0,1,0,1,0
做到,1,1,0,1,0,0
夜校,1,1,0,1,0,0
夜,1,1,1,0,0,1
多样性,1,1,0,1,0,0
多想,1,1,0,1,0,0
多少次,1,0,1,0,1,0
做啥,1,1,0,1,0,0
多余,1,1,0,1,0,0
做回,1,1,0,1,0,0
俺,1,1,0,1,0,0
外人,1,1,0,1,0,0
复杂,1,1,0,1,0,0
复发,1,1,0,1,0,0
处理,1,0,0,0,0,0
处在,1,0,1,0,1,0
境遇,1,1,0,1,0,0
填,1,1,0,1,0,0
堕落,1,1,0,1,0,0
城市里,1,0,1,0,1,0
做坏事,1,1,0,1,0,0
城,1,0,0,0,0,0
埋怨,1,1,0,1,0,0
大山,1,1,0,1,0,0
大年三十,1,1,0,1,0,0
大清早,1,1,1,0,0,1
大言不惭,1,1,0,1,0,0
倒,1,1,1,0,0,1
值得,1,1,0,1,0,0
奢求,1,1,1,0,0,1
奢望,1,1,0,1,0,0
头像,1,0,1,0,1,0
头上,1,1,0,1,0,0
失踪,1,0,0,0,0,0
失败,1,1,0,1,0,0
失望,1,1,0,1,0,0
太阳能,1,1,0,1,0,0
太长,1,1,0,1,0,0
太过,1,1,0,1,0,0
太苦,1,1,0,1,0,0
太笨,1,0,1,0,1,0
太烦,1,1,0,1,0,0
太忙,1,1,0,1,0,0
太少,1,0,1,0,1,0
偏航,1,1,0,1,0,0
天妇罗,1,1,0,1,0,0
天天,1,1,0,1,0,0
做不了,1,1,0,1,0,0
天哪,1,0,1,0,1,0
天亮,1,0,1,0,1,0
天下,1,1,0,1,0,0
大部分,1,0,1,0,1,0
安排,1,0,1,0,1,0
安琪莉,1,0,1,0,1,0
安静,1,1,0,1,0,0
巨大,1,1,0,1,0,0
常常,1,1,0,1,0,0
常事,1,0,1,0,1,0
帮忙,1,0,0,0,0,0
帮帮,1,0,0,0,0,0
帮助,1,1,0,1,0,0
带给,1,1,1,0,0,1
带来,1,0,1,0,1,0
带你,1,1,0,1,0,0
任何一个人,1,0,1,0,1,0
帖子,1,1,0,1,0,0
巴掌,1,1,0,1,0,0
巨婴,1,0,0,0,0,0
巧合,1,1,0,1,0,0
完,1,1,1,0,0,1
左耳进右耳出,1,1,0,1,0,0
左右,1,1,0,1,0,0
工资,1,1,1,0,0,1
岁月,1,1,1,0,0,1
屯,1,1,0,1,0,0
属于,1,1,1,0,0,1
展示出,1,0,1,0,1,0
屋顶,1,1,0,1,0,0
屁事,1,0,0,0,0,0
尽量,1,0,0,0,0,0
尽快,1,1,0,1,0,0
尽孝,1,1,0,1,0,0
干预,1,0,0,0,0,0
平安,1,1,0,1,0,0
平安喜乐,1,0,1,0,1,0
平静,1,0,1,0,1,0
令人窒息,1,1,0,1,0,0
开张,1,1,1,0,0,1
以及,1,0,1,0,1,0
建设,1,1,0,1,0,0
座,1,1,0,1,0,0
度过,1,0,0,0,0,0
底下,1,0,1,0,1,0
应该是,1,0,0,0,0,0
以往,1,1,0,1,0,0
应有,1,1,0,1,0,0
应当,1,0,0,0,0,0
床上,1,1,0,1,0,0
庆幸,1,1,0,1,0,0
以暴制暴,1,0,1,0,1,0
幸福吗,1,1,0,1,0,0
以至于,1,1,0,1,0,0
并且,1,0,1,0,1,0
并不是,1,0,1,0,1,0
仪式,1,1,0,1,0,0
件,1,1,0,1,0,0
年轻,1,0,0,0,0,0
年纪大,1,0,1,0,1,0
年纪,1,0,0,0,0,0
年少无知,1,1,0,1,0,0
年下,1,1,0,1,0,0
尸体,1,0,0,0,0,0
份,1,1,0,1,0,0
就让,1,0,0,0,0,0
对抗,1,0,1,0,1,0
但凡,1,0,1,0,1,0
对不起,1,0,1,0,1,0
密集,1,1,0,1,0,0
寄托,1,1,0,1,0,0
寄予,1,0,0,0,0,0
寂静,1,1,1,0,0,1
家门,1,1,0,1,0,0
住址,1,0,0,0,0,0
家财万贯,1,1,0,1,0,0
家电,1,0,1,0,1,0
家徒四壁,1,1,0,1,0,0
家庭关系,1,0,0,0,0,0
家具,1,0,1,0,1,0
何况,1,1,0,1,0,0
何处,1,1,1,0,0,1
何尝,1,0,1,0,1,0
实际,1,1,0,1,0,0
实现,1,0,1,0,1,0
何必,1,1,0,1,0,0
宝马,1,1,0,1,0,0
宝,1,0,1,0,1,0
定,1,0,1,0,1,0
余额,1,1,0,1,0,0
完成,1,1,0,1,0,0
完完全全,1,1,0,1,0,0
对吗,1,1,0,1,0,0
对立,1,0,0,0,0,0
就要,1,1,0,1,0,0
伤痛,1,1,1,0,0,1
就行,1,1,0,1,0,0
就能够,1,1,0,1,0,0
仿佛,1,1,0,1,0,0
就应该,1,1,0,1,0,0
就如,1,1,0,1,0,0
就在,1,1,0,1,0,0
休闲,1,1,0,1,0,0
优秀,1,0,1,0,1,0
少管闲事,1,1,0,1,0,0
少年,1,1,0,1,0,0
少一点,1,1,0,1,0,0
小说,1,1,0,1,0,0
小的时候,1,1,0,1,0,0
小片,1,1,0,1,0,0
小小,1,1,0,1,0,0
会所,1,0,0,0,0,0
会者,1,0,1,0,1,0
小事,1,1,0,1,0,0
伟人,1,0,1,0,1,0
传宗接代,1,1,0,1,0,0
将来,1,0,0,0,0,0
封锁,1,1,1,0,0,1
寿喜,1,1,0,1,0,0
伤心,1,1,0,1,0,0
寻找,1,1,0,1,0,0
垃圾广告,1,1,0,1,0,0
坑了,1,1,0,1,0,0
死掉,1,1,0,1,0,0
卡里,1,0,1,0,1,0
去世,1,1,0,1,0,0
内心,1,0,1,0,1,0
原来,1,1,0,1,0,0
内心深处,1,1,0,1,0,0
厕所,1,1,0,1,0,0
厌恶,1,0,1,0,1,0
压死,1,1,1,0,0,1
卵,1,0,0,0,0,0
却说,1,0,1,0,1,0
即刻,1,1,0,1,0,0
即便,1,1,0,1,0,0
危害,1,1,0,1,0,0
占,1,1,1,0,0,1
十几,1,1,0,1,0,0
博会,1,1,0,1,0,0
卖,1,1,0,1,0,0
单身歧视,1,1,0,1,0,0
单身,1,1,0,1,0,0
半点,1,1,0,1,0,0
半截,1,0,1,0,1,0
半年,1,1,0,1,0,0
千篇一律,1,1,0,1,0,0
千万次,1,1,1,0,0,1
千万不要,1,1,0,1,0,0
十几遍,1,1,0,1,0,0
十几年,1,1,0,1,0,0
去向,1,1,1,0,0,1
去过,1,1,1,0,0,1
又不,1,1,0,1,0,0
及时,1,0,1,0,1,0
变,1,0,1,0,1,0
养宠物,1,0,0,0,0,0
受害者,1,1,0,1,0,0
受委屈,1,1,0,1,0,0
受到,1,1,0,1,0,0
受伤,1,1,0,1,0,0
受不了,1,1,0,1,0,0
受,1,0,1,0,1,0
取关,1,0,1,0,1,0
内化,1,0,1,0,1,0
发狠,1,1,0,1,0,0
发消息,1,1,0,1,0,0
发泄,1,1,0,1,0,0
发型,1,1,0,1,0,0
发图,1,1,1,0,0,1
发售,1,0,1,0,1,0
内向,1,1,0,1,0,0
反过来,1,1,0,1,0,0
反应,1,1,0,1,0,0
反射,1,1,0,1,0,0
反对,1,0,0,0,0,0
反孝,1,1,0,1,0,0
反复,1,1,0,1,0,0
反倒,1,1,0,1,0,0
双休,1,1,0,1,0,0
十几岁,1,1,0,1,0,0
十个,1,0,1,0,1,0
坐着,1,0,1,0,1,0
分,1,1,0,1,0,0
冷酷,1,1,1,0,0,1
利器,1,1,0,1,0,0
初期,1,0,1,0,1,0
初中同学,1,1,1,0,0,1
刚开始,1,1,0,1,0,0
刚刚,1,0,0,0,0,0
凄惨,1,1,0,1,0,0
列表,1,1,0,1,0,0
划清,1,1,0,1,0,0
切实,1,1,0,1,0,0
分组,1,1,1,0,0,1
分手,1,1,1,0,0,1
出问题,1,1,0,1,0,0
北大,1,1,0,1,0,0
出走,1,1,0,1,0,0
出生,1,1,0,1,0,0
出现,1,0,1,0,1,0
出奇,1,1,0,1,0,0
出于,1,0,1,0,1,0
凑合,1,1,0,1,0,0
凶手,1,1,0,1,0,0
凶,1,1,0,1,0,0
凑钱,1,0,1,0,1,0
几句,1,1,0,1,0,0
几位,1,0,1,0,1,0
几个月,1,1,0,1,0,0
冷嘲热讽,1,0,0,0,0,0
别放弃,1,0,1,0,1,0
别离,1,1,0,1,0,0
别走,1,0,1,0,1,0
包括,1,1,1,0,0,1
包,1,1,0,1,0,0
勒脖子,1,1,1,0,0,1
冬眠,1,1,0,1,0,0
冲,1,1,1,0,0,1
动手,1,1,0,1,0,0
加身,1,1,1,0,0,1
加油,1,1,1,0,0,1
办法,1,0,1,0,1,0
冲动   ,1,1,0,1,0,0
割腕,1,1,1,0,0,1
割肉还血,1,0,1,0,1,0
剩下,1,1,1,0,0,1
剥夺,1,0,1,0,1,0
前阵子,1,1,1,0,0,1
前来,1,1,0,1,0,0
前前后后,1,0,0,0,0,0
前几天,1,1,0,1,0,0
刺激,1,1,0,1,0,0
刷到,1,0,1,0,1,0
制造,1,0,0,0,0,0
到时候,1,0,1,0,1,0
到家,1,1,1,0,0,1
到处,1,1,0,1,0,0
刮,1,1,1,0,0,1
口,1,0,0,0,0,0
口袋妖怪,1,1,1,0,0,1
古道,1,1,0,1,0,0
喊救命,1,1,1,0,0,1
回到,1,1,0,1,0,0
四个月,1,0,1,0,1,0
囚禁,1,1,0,1,0,0
嘿嘿,1,1,1,0,0,1
嘴巴,1,1,0,1,0,0
嘲讽,1,1,0,1,0,0
嘟嘟,1,1,0,1,0,0
嘎,1,0,1,0,1,0
嗷嗷哭,1,1,0,1,0,0
嗨喽,1,1,0,1,0,0
嗨,1,0,1,0,1,0
喘不上气来,1,1,0,1,0,0
喊出,1,0,1,0,1,0
具体位置,1,0,0,0,0,0
商量,1,0,1,0,1,0
唠叨,1,1,0,1,0,0
儿童,1,1,0,1,0,0
哭出来,1,0,1,0,1,0
允许,1,1,0,1,0,0
哪里有,1,0,1,0,1,0
哪吒,1,1,0,1,0,0
哪个,1,1,1,0,0,1
哥,1,0,0,0,0,0
哔哔,1,0,0,0,0,0
哎,1,1,0,1,0,0
光,1,1,0,1,0,0
回到家,1,1,0,1,0,0
傻,1,0,0,0,0,0
回复,1,0,1,0,1,0
催吐,1,1,0,1,0,0
坐,1,1,0,1,0,0
坏掉,1,1,0,1,0,0
地狱,1,1,0,1,0,0
做家具,1,1,0,1,0,0
做衣服,1,1,0,1,0,0
在那里,1,0,1,0,1,0
停,1,0,1,0,1,0
在这里,1,1,0,1,0,0
在哪我,1,0,0,0,0,0
健康,1,0,1,0,1,0
在下,1,0,1,0,1,0
圣母心,1,1,0,1,0,0
圈养,1,1,0,1,0,0
图,1,0,1,0,1,0
国庆节,1,1,0,1,0,0
国内外,1,0,0,0,0,0
固然,1,1,0,1,0,0
困苦,1,0,1,0,1,0
困扰,1,1,0,1,0,0
困境,1,0,1,0,1,0
因果,1,1,0,1,0,0
健身,1,1,1,0,0,1
因,1,0,0,0,0,0
偶像,1,1,0,1,0,0
傀儡,1,1,0,1,0,0
哀悼,1,1,0,1,0,0
咸鱼,1,0,1,0,1,0
咱,1,1,0,1,0,0
同城,1,1,1,0,0,1
同人,1,1,0,1,0,0
各种,1,1,0,1,0,0
各方,1,1,0,1,0,0
各地,1,1,0,1,0,0
吃遍,1,1,0,1,0,0
吃了,1,1,1,0,0,1
可能性,1,1,0,1,0,0
可能会,1,1,0,1,0,0
公司,1,0,1,0,1,0
可笑,1,1,0,1,0,0
共情能力,1,0,0,0,0,0
可怕,1,1,0,1,0,0
可以做,1,0,1,0,1,0
关于,1,1,0,1,0,0
可不可以,1,1,0,1,0,0
叭,1,1,1,0,0,1
只身一个人,1,0,0,0,0,0
关窗,1,1,1,0,0,1
只有我,1,1,0,1,0,0
关键,1,0,0,0,0,0
关门,1,1,1,0,0,1
其他,1,1,0,1,0,0
其次,1,1,0,1,0,0
另外,1,1,0,1,0,0
另一边,1,0,1,0,1,0
同住,1,0,1,0,1,0
同学,1,0,0,0,0,0
咧,1,1,0,1,0,0
同意,1,1,0,1,0,0
咒骂,1,1,0,1,0,0
咋,1,1,0,1,0,0
命运,1,0,1,0,1,0
光亮,1,1,1,0,0,1
呵呵,1,1,0,1,0,0
周围,1,1,0,1,0,0
免不了,1,0,1,0,1,0
呆在,1,0,1,0,1,0
入侵,1,1,1,0,0,1
吵闹,1,1,0,1,0,0
听说,1,0,1,0,1,0
听着,1,1,1,0,0,1
全国,1,1,0,1,0,0
全家,1,1,0,1,0,0
吧  ,1,1,0,1,0,0
否认,1,0,1,0,1,0
否定,1,0,1,0,1,0
否则,1,1,0,1,0,0
向日葵,1,1,0,1,0,0
向,1,0,0,0,0,0
吐,1,0,1,0,1,0
后面,1,0,0,0,0,0
全家人,1,1,0,1,0,0
全身,1,0,1,0,1,0
同龄人,1,0,1,0,1,0
开解,1,0,1,0,1,0
异格,1,0,1,0,1,0
式,1,1,0,1,0,0
斗志活成,1,1,0,1,0,0
方舟,1,0,1,0,1,0
为人,1,1,0,1,0,0
方向,1,1,0,1,0,0
新鲜,1,1,0,1,0,0
新词,1,0,1,0,1,0
新的征程,1,1,0,1,0,0
新梗,1,0,1,0,1,0
新家,1,1,1,0,0,1
新城市,1,1,0,1,0,0
为什么不,1,1,0,1,0,0
断联,1,0,1,0,1,0
为什么吗,1,1,0,1,0,0
为名,1,0,1,0,1,0
久,1,1,0,1,0,0
整理,1,1,1,0,0,1
为数不多,1,1,0,1,0,0
数落,1,1,0,1,0,0
数不清,1,1,0,1,0,0
敬,1,0,1,0,1,0
散散心,1,1,1,0,0,1
主人,1,0,1,0,1,0
教育方法,1,1,0,1,0,0
主动,1,1,0,1,0,0
乃至,1,0,0,0,0,0
故事,1,1,0,1,0,0
放松,1,1,0,1,0,0
方舟出live2d,1,0,1,0,1,0
旁人,1,1,0,1,0,0
旁边,1,0,1,0,1,0
旅游,1,1,1,0,0,1
早就,1,1,0,1,0,0
早上,1,1,0,1,0,0
中午,1,1,1,0,0,1
中午中午,1,1,1,0,0,1
日夜,1,1,0,1,0,0
无路可走,1,1,0,1,0,0
无趣,1,1,0,1,0,0
无论是,1,1,0,1,0,0
中心,1,1,0,1,0,0
中考,1,1,0,1,0,0
无能,1,1,0,1,0,0
无法沟通,1,1,0,1,0,0
临走,1,1,0,1,0,0
无权,1,0,1,0,1,0
无数个,1,1,0,1,0,0
无数,1,1,0,1,0,0
无意中,1,0,1,0,1,0
无助,1,1,1,0,0,1
无力感,1,1,0,1,0,0
无关,1,1,1,0,0,1
无偿奉献,1,1,0,1,0,0
无依无靠,1,1,0,1,0,0
无伤大雅,1,1,0,1,0,0
无,1,1,0,1,0,0
旅程,1,0,1,0,1,0
放手,1,1,0,1,0,0
放在,1,1,1,0,0,1
引导,1,1,0,1,0,0
挫败感,1,1,0,1,0,0
推荐,1,0,1,0,1,0
推动,1,1,0,1,0,0
推,1,1,0,1,0,0
接触,1,1,0,1,0,0
探讨,1,0,1,0,1,0
掌控欲,1,0,0,0,0,0
掉队,1,1,1,0,0,1
换洗衣服,1,1,0,1,0,0
换来,1,1,0,1,0,0
换取,1,1,0,1,0,0
挺过来,1,1,0,1,0,0
也想,1,1,0,1,0,0
挫败,1,1,0,1,0,0
放下,1,1,0,1,0,0
挣脱,1,1,0,1,0,0
挑剔,1,1,0,1,0,0
按照,1,1,0,1,0,0
也行,1,1,1,0,0,1
指望,1,1,0,1,0,0
挂机,1,1,0,1,0,0
持续,1,0,1,0,1,0
拿起,1,0,1,0,1,0
拿着,1,1,1,0,0,1
拿去,1,1,0,1,0,0
拿到,1,1,0,1,0,0
拿出来,1,0,1,0,1,0
描述,1,0,1,0,1,0
提,1,1,1,0,0,1
提交,1,0,0,0,0,0
九月,1,0,1,0,1,0
攻击性,1,0,1,0,1,0
攻击,1,0,1,0,1,0
之外,1,1,0,1,0,0
收获,1,1,0,1,0,0
收敛,1,1,0,1,0,0
收到,1,1,1,0,0,1
支持,1,0,1,0,1,0
攒,1,1,1,0,0,1
播音主持,1,1,0,1,0,0
撕坏,1,0,1,0,1,0
撕,1,0,0,0,0,0
撒满,1,1,0,1,0,0
撑不住,1,0,1,0,1,0
摧残,1,1,0,1,0,0
摔死,1,1,0,1,0,0
乙游,1,0,1,0,1,0
搬出来,1,1,1,0,0,1
九年义务教育,1,1,0,1,0,0
搬,1,1,0,1,0,0
搞,1,1,0,1,0,0
搅和,1,1,0,1,0,0
揣测,1,1,0,1,0,0
插手,1,1,0,1,0,0
提起,1,0,1,0,1,0
提议,1,0,0,0,0,0
早日,1,1,0,1,0,0
时不时,1,1,0,1,0,0
时光,1,1,0,1,0,0
本,1,0,0,0,0,0
构建,1,1,0,1,0,0
极其,1,1,0,1,0,0
松弛感,1,0,1,0,1,0
来看,1,1,1,0,0,1
来了,1,0,0,0,0,0
条理,1,0,1,0,1,0
束缚,1,1,0,1,0,0
杀人,1,0,0,0,0,0
机关,1,0,0,0,0,0
不达,1,0,1,0,1,0
不远,1,1,0,1,0,0
本田,1,1,0,1,0,0
未知,1,1,0,1,0,0
时常,1,1,0,1,0,0
不违背,1,0,1,0,1,0
未曾谋面,1,1,1,0,0,1
不问,1,1,0,1,0,0
未,1,0,1,0,1,0
期盼,1,1,0,1,0,0
期望,1,1,0,1,0,0
服药,1,1,0,1,0,0
不顺眼,1,1,0,1,0,0
有趣,1,1,1,0,0,1
有缘,1,1,0,1,0,0
有空你,1,1,1,0,0,1
有病,1,1,0,1,0,0
果然,1,1,0,1,0,0
枷锁,1,1,0,1,0,0
某个,1,1,0,1,0,0
某些,1,1,0,1,0,0
不要救,1,1,0,1,0,0
死了我,1,1,0,1,0,0
不要舔,1,1,0,1,0,0
死不瞑目,1,1,0,1,0,0
不要说,1,1,0,1,0,0
此时此刻,1,0,1,0,1,0
正式,1,1,1,0,0,1
不认可,1,1,0,1,0,0
正在,1,1,0,1,0,0
正义,1,1,0,1,0,0
欲望,1,1,0,1,0,0
欣慰,1,1,1,0,0,1
欠债,1,1,0,1,0,0
欠,1,1,1,0,0,1
概括,1,1,0,1,0,0
楼上,1,1,0,1,0,0
楼,1,1,0,1,0,0
桑,1,0,1,0,1,0
桃花,1,1,0,1,0,0
格林童话,1,1,1,0,0,1
树洞,1,1,0,1,0,0
标榜,1,1,0,1,0,0
标准,1,1,0,1,0,0
查无此人,1,1,1,0,0,1
某些人,1,1,0,1,0,0
有毛病,1,0,1,0,1,0
有所,1,0,1,0,1,0
有很多,1,1,0,1,0,0
更好,1,1,0,1,0,0
更加,1,1,0,1,0,0
两年,1,1,0,1,0,0
暴行,1,1,0,1,0,0
暗无天日,1,1,0,1,0,0
晚期,1,1,0,1,0,0
两方,1,1,0,1,0,0
晚上好,1,1,1,0,0,1
几个小时,1,1,1,0,0,1
是因为,1,0,1,0,1,0
是什么,1,1,0,1,0,0
两样,1,1,0,1,0,0
昨天晚上,1,1,0,1,0,0
严酷,1,0,1,0,1,0
春节,1,1,0,1,0,0
春天,1,1,0,1,0,0
星空,1,1,1,0,0,1
星球,1,0,1,0,1,0
星川翡翠,1,0,1,0,1,0
昏黄,1,1,0,1,0,0
明日方舟,1,0,1,0,1,0
明日,1,0,1,0,1,0
明年,1,1,0,1,0,0
明天,1,1,0,1,0,0
时间长,1,0,1,0,1,0
时间,1,0,0,0,0,0
两件,1,0,1,0,1,0
两个月,1,1,0,1,0,0
有好事,1,1,1,0,0,1
更是,1,1,0,1,0,0
有多难,1,1,0,1,0,0
有多少,1,1,0,1,0,0
有别,1,0,1,0,1,0
有信心,1,1,0,1,0,0
有什么,1,0,0,0,0,0
业余时间,1,1,0,1,0,0
丢,1,1,0,1,0,0
有事,1,0,1,0,1,0
有一点,1,0,1,0,1,0
丢下,1,1,0,1,0,0
月光,1,1,0,1,0,0
最难,1,1,0,1,0,0
丢了,1,1,0,1,0,0
最能,1,1,0,1,0,0
最爱,1,1,0,1,0,0
最早,1,1,0,1,0,0
最后关头,1,1,0,1,0,0
最后一次,1,0,1,0,1,0
最后一句话,1,1,0,1,0,0
最后一刻,1,0,1,0,1,0
丢人现眼,1,0,1,0,1,0
丢掉,1,0,1,0,1,0
替,1,0,1,0,1,0
两个,1,1,1,0,0,1
更糟糕,1,0,1,0,1,0
拿,1,0,1,0,1,0
拼装,1,0,1,0,1,0
拼好,1,0,1,0,1,0
怎么办,1,1,0,1,0,0
恍悟,1,0,1,0,1,0
总是要,1,1,0,1,0,0
什么样,1,0,1,0,1,0
怪圈,1,1,0,1,0,0
怪,1,0,0,0,0,0
性格,1,1,0,1,0,0
思想,1,1,0,1,0,0
怕疼,1,1,0,1,0,0
什么样子,1,1,0,1,0,0
什么玩意儿,1,0,0,0,0,0
怎么选择,1,1,0,1,0,0
怎么搞,1,0,0,0,0,0
仅有,1,1,0,1,0,0
想见,1,0,1,0,1,0
态度,1,1,0,1,0,0
怀疑,1,0,1,0,1,0
快要,1,0,1,0,1,0
快活,1,1,0,1,0,0
今天上午,1,1,1,0,0,1
今天中午,1,1,1,0,0,1
忘记,1,0,1,0,1,0
忘不了,1,1,1,0,0,1
忍气吞声,1,1,0,1,0,0
必然,1,1,0,1,0,0
今天早上,1,0,1,0,1,0
心酸,1,1,0,1,0,0
恢复存档,1,0,1,0,1,0
恨透,1,1,1,0,0,1
恶臭,1,0,1,0,1,0
恶语相向,1,1,0,1,0,0
人们,1,1,1,0,0,1
想看,1,1,0,1,0,0
想清楚,1,1,0,1,0,0
想法  ,1,1,0,1,0,0
人口,1,1,0,1,0,0
人和,1,1,0,1,0,0
想方设法,1,0,0,0,0,0
想念,1,0,1,0,1,0
想哭,1,1,0,1,0,0
想到,1,1,0,1,0,0
想做什么,1,0,1,0,1,0
人肉,1,1,0,1,0,0
想不开,1,0,1,0,1,0
想不出来,1,0,1,0,1,0
什么东西,1,1,0,1,0,0
惬意,1,1,0,1,0,0
什么事,1,1,0,1,0,0
惊讶,1,1,1,0,0,1
情绪,1,1,0,1,0,0
情况,1,0,0,0,0,0
悲痛,1,1,0,1,0,0
悲惨,1,1,0,1,0,0
悲剧,1,1,0,1,0,0
悲伤,1,1,0,1,0,0
什么关系,1,1,0,1,0,0
心累,1,1,0,1,0,0
心痛,1,1,0,1,0,0
心疼,1,1,0,1,0,0
很小,1,1,1,0,0,1
很多年,1,1,0,1,0,0
很多岁,1,1,0,1,0,0
很多事,1,0,1,0,1,0
他们自己,1,0,1,0,1,0
很可能,1,0,1,0,1,0
很可爱,1,0,1,0,1,0
很久,1,0,1,0,1,0
待在,1,0,1,0,1,0
待会,1,0,1,0,1,0
待,1,0,1,0,1,0
彻底,1,0,1,0,1,0
影子,1,1,1,0,0,1
当着,1,1,0,1,0,0
当然,1,1,0,1,0,0
当成,1,1,0,1,0,0
当天晚上,1,1,0,1,0,0
当地,1,0,0,0,0,0
当初,1,1,0,1,0,0
仙剑,1,1,0,1,0,0
强袭,1,0,1,0,1,0
强硬,1,1,0,1,0,0
强大,1,1,0,1,0,0
弥补,1,1,1,0,0,1
张家港,1,0,0,0,0,0
弟弟,1,1,0,1,0,0
很容易,1,1,0,1,0,0
很少,1,1,0,1,0,0
心理学,1,1,0,1,0,0
很有,1,0,1,0,1,0
心狠,1,1,0,1,0,0
心灵,1,1,0,1,0,0
心有戚戚焉,1,1,0,1,0,0
心意,1,0,0,0,0,0
今生,1,0,1,0,1,0
心思细腻,1,0,0,0,0,0
心心,1,1,1,0,0,1
心如死灰,1,1,0,1,0,0
心凉,1,1,1,0,0,1
介绍,1,1,0,1,0,0
德,1,0,0,0,0,0
微小,1,1,0,1,0,0
微博  ,1,1,0,1,0,0
仍没,1,1,1,0,0,1
微不足道,1,0,0,0,0,0
循序渐进,1,1,0,1,0,0
仍然,1,1,0,1,0,0
得不到,1,1,0,1,0,0
很远,1,1,0,1,0,0
很老,1,1,0,1,0,0
很美,1,0,1,0,1,0
从未,1,1,0,1,0,0
很糟糕,1,1,1,0,0,1
很生气,1,1,0,1,0,0
很火,1,1,1,0,0,1
人人,1,1,0,1,0,0
想说,1,0,1,0,1,0
拯救,1,0,1,0,1,0
托,1,0,1,0,1,0
承认,1,0,0,0,0,0
承担,1,1,0,1,0,0
承受,1,0,1,0,1,0
找找,1,0,1,0,1,0
找对象,1,1,0,1,0,0
了如指掌,1,0,0,0,0,0
争,1,1,0,1,0,0
批判,1,0,1,0,1,0
扮演,1,1,0,1,0,0
扩散,1,0,1,0,1,0
执念,1,0,1,0,1,0
托付,1,1,0,1,0,0
扔进,1,1,0,1,0,0
想象,1,0,1,0,1,0
打麻将,1,1,0,1,0,0
打的,1,1,1,0,0,1
打招呼,1,0,1,0,1,0
打扰,1,0,1,0,1,0
打开,1,0,1,0,1,0
打工,1,1,0,1,0,0
打印,1,1,0,1,0,0
争强好胜,1,1,0,1,0,0
事与愿违,1,0,1,0,1,0
才知道,1,1,0,1,0,0
事实上,1,1,0,1,0,0
二十年,1,1,0,1,0,0
了  ,1,0,1,0,1,0
把握,1,1,0,1,0,0
抓不住,1,0,1,0,1,0
抓住,1,1,1,0,0,1
书籍,1,0,0,0,0,0
拥抱,1,0,1,0,1,0
拜托,1,0,1,0,1,0
拘束,1,1,0,1,0,0
拖到,1,1,0,1,0,0
拔,1,1,0,1,0,0
拒绝,1,1,0,1,0,0
拉黑,1,1,0,1,0,0
拉着,1,1,0,1,0,0
拉去,1,0,0,0,0,0
拆封,1,0,1,0,1,0
担心,1,0,0,0,0,0
抹去,1,1,0,1,0,0
抵不过,1,0,0,0,0,0
抱着,1,0,1,0,1,0
抱,1,0,1,0,1,0
买到,1,0,0,0,0,0
报应,1,0,1,0,1,0
乱七八糟,1,0,0,0,0,0
护肤品,1,1,0,1,0,0
抢救,1,1,0,1,0,0
抛弃,1,0,1,0,1,0
乱开,1,1,0,1,0,0
投放,1,1,0,1,0,0
抓到,1,0,1,0,1,0
手机,1,1,1,0,0,1
手办,1,1,0,1,0,0
扇,1,1,0,1,0,0
交代,1,1,0,1,0,0
交接,1,0,0,0,0,0
懦弱,1,1,0,1,0,0
懦夫,1,0,0,0,0,0
懂得,1,1,0,1,0,0
懂了,1,0,0,0,0,0
产生,1,0,1,0,1,0
慨他人之康,1,0,1,0,1,0
慢慢出现,1,0,0,0,0,0
慢慢,1,1,0,1,0,0
慢性,1,1,1,0,0,1
愧疚,1,0,1,0,1,0
感情,1,1,0,1,0,0
亲戚家,1,1,0,1,0,0
感同深受,1,1,0,1,0,0
亲手,1,1,0,1,0,0
感受,1,1,0,1,0,0
感到,1,0,1,0,1,0
愚蠢,1,0,0,0,0,0
意识,1,0,1,0,1,0
意志,1,1,0,1,0,0
意外,1,1,0,1,0,0
愉快,1,0,1,0,1,0
想通,1,1,0,1,0,0
人世,1,1,1,0,0,1
人中,1,1,0,1,0,0
成全,1,1,0,1,0,0
些许,1,1,0,1,0,0
所谓,1,1,0,1,0,0
成年人,1,1,0,1,0,0
二时,1,1,0,1,0,0
于,1,1,0,1,0,0
所在,1,0,1,0,1,0
亏,1,0,1,0,1,0
互,1,0,1,0,1,0
房间里,1,1,0,1,0,0
房间,1,0,1,0,1,0
房租,1,0,1,0,1,0
截图,1,1,0,1,0,0
互不,1,0,1,0,1,0
或是,1,1,0,1,0,0
或,1,1,0,1,0,0
我身边,1,1,0,1,0,0
互相尊重,1,1,0,1,0,0
互联网,1,1,0,1,0,0
五个,1,1,1,0,0,1
我姨,1,1,0,1,0,0
五月天,1,1,0,1,0,0
我女儿,1,1,0,1,0,0
我哥,1,0,1,0,1,0
我儿子,1,1,0,1,0,0
我们自己,1,1,0,1,0,0
我们俩,1,1,1,0,0,1
  和,1,1,1,0,0,1
成本,1,1,0,1,0,0
?连,1,1,0,1,0,0
 ,0,0,0,5,3,1
