Words,All,Tree Hole,Wailing Wall,Unique Tree Hole,Unique Wailing Wall,Both
你,402,33,377,25,369,8
我,256,93,176,67,150,26
他,132,18,85,16,83,2
希望,69,12,52,12,52,0
你们,49,5,44,5,44,0
世界,47,13,34,12,33,1
人,45,22,23,20,21,2
一个,38,10,30,8,28,2
这个,37,12,21,11,20,1
玫瑰,37,2,36,1,35,1
真的,36,14,20,13,19,1
我们,36,4,29,2,27,2
朋友,36,4,19,3,18,1
自己,33,14,22,11,19,3
为,32,6,28,4,26,2
爱,31,10,25,6,21,4
刘学州,29,2,25,2,25,0
好,29,7,24,4,21,3
如果,28,3,22,2,21,1
可以,27,3,21,2,20,1
没有,27,8,18,8,18,0
看到,25,5,17,4,16,1
说,24,8,14,7,13,1
弟弟,23,1,22,1,22,0
想,23,9,13,8,12,1
不要,22,9,13,7,11,2
今天,22,4,18,4,18,0
去找,22,0,22,0,22,0
幸福,21,4,19,2,17,2
但是,21,8,12,7,11,1
孩子,21,9,12,8,11,1
活着,21,9,15,6,12,3
现在,21,6,13,4,11,2
照顾,21,0,21,0,21,0
一定,21,4,16,3,15,1
还是,20,6,14,5,13,1
微博,20,0,17,0,17,0
愿,19,2,18,1,17,1
一定要,19,2,14,1,13,1
记得,19,1,16,1,16,0
好好,19,5,14,5,14,0
关注,19,1,16,1,16,0
离开,18,4,14,4,14,0
年年,18,1,18,0,17,1
再,18,8,9,8,9,0
道森,18,0,16,0,16,0
大家,18,5,12,3,10,2
快乐,18,3,14,3,14,0
不知道,17,4,11,4,11,0
生活,17,8,12,5,9,3
因为,17,11,6,11,6,0
喜欢,17,4,12,4,12,0
?,17,1,16,1,16,0
一下,17,2,10,2,10,0
还有,17,4,13,3,12,1
已经,16,4,8,4,8,0
小鹿,16,3,12,3,12,0
也是,16,9,10,6,7,3
不会,16,7,12,4,9,3
一样,16,4,13,3,12,1
知道,16,6,8,5,7,1
很多,16,5,11,4,10,1
鹿道森,15,5,9,4,8,1
请,15,4,9,3,8,1
里,15,4,8,4,8,0
时候,15,4,12,3,11,1
小,15,0,15,0,15,0
舟山,15,0,8,0,8,0
叫,15,0,15,0,15,0
这么,15,1,13,1,13,0
温柔,15,2,14,1,13,1
痛苦,15,9,8,7,6,2
在那边,14,0,14,0,14,0
遇到,14,0,13,0,13,0
走,13,6,9,3,6,3
拍,13,2,11,2,11,0
“,13,6,7,6,7,0
”,13,6,7,6,7,0
父母,13,4,8,4,8,0
多,12,1,9,1,9,0
联系,12,0,2,0,2,0
找到,12,1,6,1,6,0
找,12,3,6,3,6,0
上,12,3,7,3,7,0
互相,12,1,11,1,11,0
美好,12,2,11,1,10,1
更,12,8,8,4,4,4
就是,12,6,7,5,6,1
作品,12,0,12,0,12,0
永远,12,3,10,2,9,1
温暖,11,3,8,3,8,0
一起,11,2,9,2,9,0
好好的,11,1,10,1,10,0
有人,11,3,5,3,5,0
平安,11,2,9,1,8,1
把,11,3,9,2,8,1
而,11,7,4,7,4,0
杭州,11,0,6,0,6,0
那么,11,1,10,1,10,0
摄影,11,2,10,1,9,1
用,11,3,7,3,7,0
为什么,10,2,8,2,8,0
两个,10,0,9,0,9,0
盛放,10,0,10,0,10,0
别人,10,3,8,2,7,1
鹿,10,0,9,0,9,0
一直,10,2,7,2,7,0
盛开,10,0,10,0,10,0
玩,10,0,10,0,10,0
坚持,10,5,6,4,5,1
一点,10,3,7,2,6,1
难过,10,2,8,1,7,1
开心,10,4,7,3,6,1
也有,9,0,9,0,9,0
下辈子,9,1,7,1,7,0
事情,9,3,5,2,4,1
好看,9,2,7,2,7,0
哥哥,9,4,7,2,5,2
消息,9,1,5,0,4,1
最,9,5,8,1,4,4
努力,9,3,5,2,4,1
另一个,9,3,6,3,6,0
生日,8,2,6,2,6,0
很好,8,4,4,4,4,0
鹿鹿,8,1,7,1,7,0
虽然,8,1,7,1,7,0
像,8,1,7,1,7,0
觉得,8,2,7,1,6,1
感受,8,5,4,4,3,1
才,8,2,6,2,6,0
只是,8,3,3,3,3,0
选择,8,0,8,0,8,0
然后,8,3,5,3,5,0
一个人,8,5,3,5,3,0
下去,8,3,6,2,5,1
接,8,2,6,2,6,0
大海,8,1,6,0,5,1
妈妈,8,6,2,6,2,0
一切,7,5,2,5,2,0
们,7,2,5,2,5,0
非常,7,0,7,0,7,0
当,7,1,6,1,6,0
评论,7,4,3,4,3,0
摄影师,7,0,4,0,4,0
遗书,7,5,1,5,1,0
都是,7,1,6,1,6,0
天堂,7,0,6,0,6,0
发现,7,1,7,0,6,1
开始,7,5,2,5,2,0
以后,7,1,6,1,6,0
方式,7,2,3,2,3,0
值得,7,1,7,0,6,1
吃,7,0,7,0,7,0
可是,7,2,6,1,5,1
宝贝,7,1,6,1,6,0
回来,7,0,7,0,7,0
别,7,1,6,1,6,0
它,7,3,4,3,4,0
下,7,0,6,0,6,0
照片,7,2,4,2,4,0
与,7,2,6,1,5,1
他们,7,1,6,1,6,0
晚安,7,3,5,2,4,1
15岁,6,0,6,0,6,0
祝,6,0,6,0,6,0
是不是,6,2,3,2,3,0
?,6,0,5,0,5,0
未来,6,1,5,1,5,0
一些,6,2,5,1,4,1
回,6,1,6,0,5,1
孤独,6,4,2,4,2,0
看看,6,0,4,0,4,0
突然,6,0,4,0,4,0
来世,6,0,6,0,6,0
这些,6,0,6,0,6,0
优秀,6,1,4,1,4,0
最近,6,0,5,0,5,0
以,6,1,5,1,5,0
好像,6,4,3,3,2,1
绽放,6,1,6,0,5,1
家庭,6,2,4,2,4,0
帮,6,0,5,0,5,0
认识,6,0,5,0,5,0
有事,6,0,6,0,6,0
善良,6,0,5,0,5,0
男孩,6,1,5,1,5,0
成为,6,2,4,2,4,0
地,6,3,4,2,3,1
人生,6,2,4,2,4,0
地方,6,1,5,1,5,0
不是,6,1,5,1,5,0
所以,6,0,6,0,6,0
不能,6,4,2,4,2,0
点,6,1,5,1,5,0
还会,6,3,1,3,1,0
想你,6,3,5,1,3,2
生,6,4,2,4,2,0
霸凌,6,2,4,2,4,0
阳光,6,1,6,0,5,1
校园霸凌,5,2,4,1,3,1
后来,5,3,3,2,2,1
最后,5,1,3,1,3,0
结束,5,0,4,0,4,0
伤害,5,1,4,1,4,0
爸妈,5,5,0,5,0,0
昨天,5,2,3,2,3,0
后,5,0,4,0,4,0
自杀,5,3,2,3,2,0
告诉,5,2,3,2,3,0
家里,5,4,2,3,1,1
里面,5,1,4,0,3,1
感觉,5,0,5,0,5,0
今年,5,2,4,1,3,1
这种,5,0,4,0,4,0
好吗,5,0,5,0,5,0
哭,5,1,4,1,4,0
唯一,5,1,4,1,4,0
等,5,0,4,0,4,0
有点,5,3,2,3,2,0
陪,5,0,5,0,5,0
什么,5,2,4,1,3,1
人间,5,2,3,2,3,0
你好,5,1,5,0,4,1
属于,5,2,3,2,3,0
中,5,1,3,0,2,1
见面,5,1,4,1,4,0
只愿,5,2,4,1,3,1
春天,5,4,2,3,1,1
新,5,0,4,0,4,0
只,5,1,4,1,4,0
应该,5,1,5,0,4,1
见到,5,3,4,1,2,2
还在,5,2,4,0,2,2
那个,5,0,4,0,4,0
住,5,2,3,2,3,0
得,5,2,4,1,3,1
活,5,1,4,1,4,0
治愈,5,2,4,1,3,1
一位,5,1,3,1,3,0
男,5,0,4,0,4,0
很多人,5,0,5,0,5,0
心里,5,3,3,2,2,1
东西,5,0,5,0,5,0
海边,5,0,4,0,4,0
压力,5,3,3,2,2,1
@杭州网警,5,0,0,0,0,0
还没有,4,1,1,1,1,0
你自己,4,0,4,0,4,0
只要,4,2,2,2,2,0
关心,4,0,4,0,4,0
可能,4,1,3,1,3,0
发生,4,0,2,0,2,0
刚刚,4,0,2,0,2,0
任何人,4,3,1,3,1,0
千万别,4,0,4,0,4,0
其实,4,3,2,2,1,1
只有,4,2,1,2,1,0
别这样,4,0,4,0,4,0
经历过,4,2,3,1,2,1
从小,4,3,1,3,1,0
十五岁,4,0,4,0,4,0
内心,4,1,3,1,3,0
轨迹,4,0,0,0,0,0
好吃,4,0,4,0,4,0
过敏,4,4,0,4,0,0
发,4,0,1,0,1,0
圈,4,0,1,0,1,0
苦,4,0,4,0,4,0
化成,4,0,4,0,4,0
解脱,4,2,2,2,2,0
过来,4,3,1,3,1,0
作为,4,0,4,0,4,0
任何,4,2,2,2,2,0
所,4,1,4,0,3,1
出生,4,1,3,1,3,0
相似,4,3,1,3,1,0
活下去,4,0,4,0,4,0
恶心,4,4,0,4,0,0
猫,4,2,2,2,2,0
总是,4,1,3,1,3,0
放弃,4,2,3,1,2,1
都会,4,0,4,0,4,0
生命,4,1,2,1,2,0
不用,4,2,4,0,2,2
那边,4,0,3,0,3,0
没人,4,0,4,0,4,0
报警,4,0,1,0,1,0
无论,4,3,2,2,1,1
很棒,4,0,4,0,4,0
电话,4,0,2,0,2,0
很多很多,4,1,3,1,3,0
一天,4,0,4,0,4,0
海水,4,0,4,0,4,0
按,4,0,4,0,4,0
或许,4,2,2,2,2,0
才是,4,1,3,1,3,0
抱歉,4,1,3,1,3,0
一路走好,4,0,4,0,4,0
一边,4,4,4,0,0,4
灵魂,4,1,3,1,3,0
所有,4,0,4,0,4,0
一次,4,4,0,4,0,0
懂,4,1,3,1,3,0
或者,4,1,0,1,0,0
陌生人,4,0,4,0,4,0
一条,4,0,2,0,2,0
附近,4,0,0,0,0,0
我家,4,1,3,1,3,0
热爱,4,2,4,0,2,2
彼此,4,0,4,0,4,0
一点点,4,2,2,2,2,0
学州,4,0,4,0,4,0
这样,4,1,3,1,3,0
麻烦,4,0,3,0,3,0
寻找,4,1,1,1,1,0
森森,4,0,4,0,4,0
612,4,0,4,0,4,0
神话,4,0,4,0,4,0
种,4,0,4,0,4,0
次,4,3,1,3,1,0
穷,4,4,1,3,0,1
#,4,2,0,2,0,0
小朋友,4,0,4,0,4,0
带,4,1,3,1,3,0
看完,4,0,4,0,4,0
出现,4,1,2,1,2,0
帽,4,0,4,0,4,0
死亡,4,3,1,3,1,0
时间,4,1,3,0,2,1
拥有,3,0,3,0,3,0
拜托,3,0,3,0,3,0
刷到,3,1,1,1,1,0
名字,3,0,1,0,1,0
可怜,3,1,2,1,2,0
有才华,3,0,3,0,3,0
分享,3,2,2,1,1,1
有机会,3,0,3,0,3,0
有什么,3,1,2,1,2,0
贵州,3,0,2,0,2,0
杀死,3,1,2,1,2,0
拯救,3,1,2,1,2,0
拍照,3,0,3,0,3,0
吃了,3,2,2,1,1,1
每次,3,1,2,1,2,0
梦想,3,1,2,1,2,0
来了,3,3,1,2,0,1
海,3,0,1,0,1,0
日子,3,1,2,1,2,0
新闻,3,0,3,0,3,0
没事,3,0,3,0,3,0
原来,3,0,1,0,1,0
没办法,3,0,3,0,3,0
明明,3,0,3,0,3,0
教,3,0,3,0,3,0
明白,3,3,0,3,0,0
没有什么,3,1,2,1,2,0
记忆,3,1,2,1,2,0
星球,3,0,3,0,3,0
故事,3,1,2,1,2,0
要开心,3,0,3,0,3,0
西湖,3,0,3,0,3,0
该,3,0,3,0,3,0
变得,3,1,3,0,2,1
没能,3,1,2,1,2,0
及时,3,0,1,0,1,0
挽留,3,0,3,0,3,0
文章,3,0,1,0,1,0
算,3,0,3,0,3,0
渴望,3,2,1,2,1,0
眼泪,3,0,3,0,3,0
相同,3,0,3,0,3,0
天使,3,0,3,0,3,0
相处,3,0,3,0,3,0
帮忙,3,1,1,1,1,0
看着,3,0,3,0,3,0
工作,3,1,2,1,2,0
真,3,0,3,0,3,0
继续,3,1,2,1,2,0
结果,3,1,2,1,2,0
居然,3,1,2,1,2,0
真的好,3,0,3,0,3,0
太苦,3,0,2,0,2,0
就好,3,1,2,1,2,0
告别,3,1,2,1,2,0
女,3,1,3,0,2,1
眼睛,3,1,2,1,2,0
少年,3,1,2,1,2,0
好不好,3,0,3,0,3,0
好久,3,1,2,1,2,0
积极,3,2,2,0,0,2
安慰,3,2,2,1,1,1
竟然,3,1,2,1,2,0
好多,3,1,2,1,2,0
简单,3,1,3,0,2,1
糖,3,0,2,0,2,0
好起来,3,1,2,1,2,0
多少次,3,2,1,2,1,0
得到,3,1,2,1,2,0
多多,3,0,3,0,3,0
心,3,3,1,2,0,1
才会,3,2,1,2,1,0
脱离,3,0,3,0,3,0
点赞,3,1,2,1,2,0
能够,3,0,3,0,3,0
能不能,3,0,1,0,1,0
精灵,3,0,3,0,3,0
照亮,3,2,2,1,1,1
感同身受,3,2,1,2,1,0
图片评论,3,0,0,0,0,0
感受到,3,1,2,1,2,0
爱着,3,0,3,0,3,0
在一起,3,1,2,1,2,0
想要,3,2,2,1,1,1
想法,3,2,0,2,0,0
爸爸,3,2,1,2,1,0
想到,3,0,3,0,3,0
王子,3,1,2,1,2,0
思想,3,3,0,3,0,0
考上,3,2,1,2,1,0
怎么,3,1,1,1,1,0
快回来吧,3,0,3,0,3,0
老师,3,0,3,0,3,0
老,3,3,0,3,0,0
多久,3,1,2,1,2,0
生日快乐,3,0,3,0,3,0
背负,3,0,3,0,3,0
坚强,3,2,1,2,1,0
不敢,3,3,2,1,0,2
公安,3,0,1,0,1,0
世间,3,1,3,0,2,1
遭遇,3,1,3,0,2,1
不够,3,2,1,2,1,0
冰冷,3,0,3,0,3,0
不再,3,0,3,0,3,0
鹿先生,3,0,3,0,3,0
25岁,3,1,2,1,2,0
也不是,3,2,1,2,1,0
长大,3,2,1,2,1,0
逃离,3,2,2,1,1,1
送给,3,0,3,0,3,0
内容,3,2,0,2,0,0
问题,3,1,1,1,1,0
阿森,3,0,3,0,3,0
进,3,1,3,0,2,1
那些,3,0,3,0,3,0
这里,3,0,3,0,3,0
一辈子,3,1,2,1,2,0
光,3,3,2,1,0,2
一起去,3,0,3,0,3,0
充满,3,0,3,0,3,0
人们,3,0,0,0,0,0
这么多,3,2,1,2,1,0
需要,3,2,0,2,0,0
傻,3,0,3,0,3,0
风,3,0,3,0,3,0
一朵,3,0,3,0,3,0
会不会,3,0,3,0,3,0
做傻事,3,0,2,0,2,0
一场,3,1,3,0,2,1
鼓励,3,1,2,1,2,0
信,3,1,2,1,2,0
11.28,3,0,2,0,2,0
不过,3,1,2,1,2,0
世上,3,1,2,1,2,0
不管,3,2,1,2,1,0
走向,3,1,2,1,2,0
配不上,3,0,3,0,3,0
出,3,0,3,0,3,0
那种,3,2,1,2,1,0
这段话,2,2,2,0,0,2
难受,2,1,1,1,1,0
这辈子,2,0,1,0,1,0
这句话,2,1,1,1,1,0
什么时候,2,1,1,1,1,0
清醒,2,1,2,0,1,1
抑郁症,2,1,1,1,1,0
好多人,2,0,2,0,2,0
投,2,0,2,0,2,0
投胎,2,2,0,2,0,0
安心,2,2,0,2,0,0
仍然,2,1,1,1,1,0
快回来,2,0,2,0,2,0
抛弃,2,0,2,0,2,0
报,2,0,2,0,2,0
交,2,1,1,1,1,0
这个人,2,1,1,1,1,0
一生,2,1,1,0,0,1
抱抱,2,0,2,0,2,0
手,2,1,2,0,1,1
心态,2,2,1,1,0,1
雪,2,1,2,0,1,1
雨,2,1,1,1,1,0
找不到,2,0,0,0,0,0
扩散,2,0,0,0,0,0
很难,2,0,2,0,2,0
学生,2,0,2,0,2,0
不负,2,0,2,0,2,0
打,2,0,2,0,2,0
亲戚家,2,2,0,2,0,0
亲爱的,2,0,2,0,2,0
童年,2,2,1,1,0,1
怎么办,2,1,1,1,1,0
第一次,2,0,1,0,1,0
安好,2,1,2,0,1,1
不要让,2,0,2,0,2,0
这样的,2,0,2,0,2,0
人世,2,1,2,0,1,1
等着,2,0,2,0,2,0
快点,2,0,2,0,2,0
等等,2,0,2,0,2,0
他人,2,1,2,0,1,1
人命关天,2,0,0,0,0,0
如何,2,1,1,1,1,0
深渊,2,1,0,1,0,0
红,2,1,1,1,1,0
流浪猫,2,0,2,0,2,0
多少,2,2,0,2,0,0
一定可以,2,0,2,0,2,0
美食,2,1,1,1,1,0
多么,2,1,1,1,1,0
体会,2,2,1,1,0,1
浪漫,2,1,2,0,1,1
浙江,2,0,1,0,1,0
羡慕,2,0,2,0,2,0
翻,2,0,2,0,2,0
声音,2,0,2,0,2,0
还小,2,0,2,0,2,0
一处,2,0,2,0,2,0
城市,2,0,0,0,0,0
城堡,2,0,2,0,2,0
你们俩,2,0,2,0,2,0
甚至,2,1,1,1,1,0
依然,2,0,1,0,1,0
活下来,2,0,2,0,2,0
一名,2,0,2,0,2,0
洲洲,2,0,2,0,2,0
还好吗,2,0,2,0,2,0
大,2,0,2,0,2,0
穷人,2,2,2,0,0,2
靠,2,1,0,1,0,0
拉住,2,0,1,0,1,0
一步,2,2,0,2,0,0
淡漠,2,2,2,0,0,2
经历,2,0,2,0,2,0
头,2,0,2,0,2,0
经常,2,1,1,1,1,0
失去,2,2,2,0,0,2
那里,2,1,1,1,1,0
以为,2,2,1,1,0,1
给予,2,1,0,1,0,0
一定能,2,0,2,0,2,0
太多,2,1,2,0,1,1
太冷,2,0,2,0,2,0
还能,2,0,2,0,2,0
优先,2,0,0,0,0,0
挣扎,2,0,2,0,2,0
传达,2,0,1,0,1,0
大学,2,2,0,2,0,0
海南,2,0,2,0,2,0
罪,2,0,2,0,2,0
完全,2,1,1,1,1,0
漂亮,2,0,2,0,2,0
些,2,0,1,0,1,0
岁,2,0,2,0,2,0
不准,2,0,2,0,2,0
相遇,2,0,2,0,2,0
爷爷奶奶,2,1,1,1,1,0
玩儿,2,0,2,0,2,0
为了,2,1,1,1,1,0
帮帮,2,0,0,0,0,0
帮助,2,0,1,0,1,0
为人,2,1,1,1,1,0
道别,2,0,2,0,2,0
意义,2,1,1,1,1,0
意外,2,1,0,1,0,0
意思,2,0,1,0,1,0
之前,2,0,2,0,2,0
很可爱,2,0,2,0,2,0
乐,2,0,2,0,2,0
错,2,0,2,0,2,0
看见,2,0,2,0,2,0
州州,2,0,2,0,2,0
不一样,2,0,2,0,2,0
也不,2,0,2,0,2,0
岛,2,0,0,0,0,0
平安无事,2,0,2,0,2,0
平平安安,2,1,2,0,1,1
平行,2,0,2,0,2,0
开,2,0,2,0,2,0
当时,2,1,1,1,1,0
不好,2,1,0,1,0,0
往,2,0,0,0,0,0
留守儿童,2,2,1,1,0,1
那么多,2,0,2,0,2,0
的人,2,1,1,1,1,0
犹豫,2,0,2,0,2,0
您,2,0,1,0,1,0
悬崖,2,0,0,0,0,0
两次,2,0,2,0,2,0
留,2,0,2,0,2,0
情况,2,0,0,0,0,0
情绪,2,1,1,1,1,0
留下来,2,0,2,0,2,0
重庆火锅,2,0,2,0,2,0
并,2,1,1,1,1,0
年轻人,2,1,1,1,1,0
年轻,2,0,1,0,1,0
不在,2,0,1,0,1,0
不同,2,0,2,0,2,0
性格,2,1,1,1,1,0
也好,2,0,2,0,2,0
留恋,2,0,2,0,2,0
感谢,2,0,0,0,0,0
烦透,2,2,0,2,0,0
很想,2,0,2,0,2,0
烤红薯,2,0,2,0,2,0
我自己,2,1,1,1,1,0
或,2,0,1,0,1,0
过去,2,0,2,0,2,0
神明,2,0,2,0,2,0
对不对,2,0,2,0,2,0
七,2,0,2,0,2,0
远离,2,0,2,0,2,0
离去,2,1,1,1,1,0
很爱,2,0,2,0,2,0
私信,2,0,1,0,1,0
所在,2,1,0,1,0,0
家人,2,0,2,0,2,0
家,2,2,0,2,0,0
互动,2,0,1,0,1,0
实现,2,1,1,1,1,0
怎么回事,2,0,0,0,0,0
这边,2,0,2,0,2,0
定时,2,1,1,0,0,1
事,2,1,1,1,1,0
成功,2,0,2,0,2,0
小孩,2,1,1,1,1,0
很大,2,0,2,0,2,0
局,2,0,1,0,1,0
长,2,0,2,0,2,0
重庆,2,0,2,0,2,0
真的有,2,1,1,1,1,0
愿意,2,1,1,1,1,0
也许,2,1,1,1,1,0
就要,2,0,2,0,2,0
就算,2,0,2,0,2,0
买,2,0,2,0,2,0
就会,2,1,1,1,1,0
确,2,0,2,0,2,0
长线,2,2,0,2,0,0
了       ,2,2,0,2,0,0
不应该,2,0,1,0,1,0
送,2,0,2,0,2,0
小路,2,0,0,0,0,0
那时,2,0,2,0,2,0
小房子,2,0,2,0,2,0
硝烟,2,0,2,0,2,0
小小,2,0,2,0,2,0
陪伴,2,0,2,0,2,0
带你,2,0,2,0,2,0
止不住,2,0,2,0,2,0
路,2,1,1,1,1,0
死,2,1,1,1,1,0
高彦,2,0,2,0,2,0
只为了,2,2,0,2,0,0
明年,2,0,2,0,2,0
鲜活,2,0,1,0,1,0
星火,2,0,2,0,2,0
受到,2,0,2,0,2,0
受,2,2,0,2,0,0
@,2,0,2,0,2,0
关机,2,0,0,0,0,0
要是,2,0,2,0,2,0
星辰,2,0,2,0,2,0
养,2,2,0,2,0,0
春暖花开,2,0,2,0,2,0
再来,2,1,1,1,1,0
27号,2,0,0,0,0,0
去往,2,0,2,0,2,0
森林,2,0,0,0,0,0
晚上,2,0,1,0,1,0
25年,2,1,1,1,1,0
警察,2,0,1,0,1,0
马上,2,0,2,0,2,0
只能,2,1,1,1,1,0
听到,2,1,1,1,1,0
早就,2,0,1,0,1,0
后悔,2,0,2,0,2,0
先,2,1,1,1,1,0
比,2,0,2,0,2,0
―,2,0,2,0,2,0
°,2,0,2,0,2,0
各种,2,2,0,2,0,0
荆棘,2,0,2,0,2,0
每年,2,0,2,0,2,0
每天,2,1,1,1,1,0
每个人,2,0,2,0,2,0
无限,2,0,2,0,2,0
日出,2,0,2,0,2,0
可能性,2,0,1,0,1,0
每一次,2,0,2,0,2,0
可惜,2,1,1,1,1,0
入,2,0,1,0,1,0
日记,2,0,2,0,2,0
身上,2,2,1,1,0,1
每一个,2,2,0,2,0,0
残忍,2,2,0,2,0,0
跳舞,2,0,2,0,2,0
森,2,0,2,0,2,0
警方,2,0,0,0,0,0
计划,2,1,1,1,1,0
认为,2,0,2,0,2,0
包围,2,0,2,0,2,0
走进,2,0,2,0,2,0
勇敢,2,0,2,0,2,0
有了,2,0,1,0,1,0
?,2,0,2,0,2,0
加油,2,0,2,0,2,0
束,2,0,2,0,2,0
有啥,2,1,0,1,0,0
机会,2,0,2,0,2,0
谢谢,2,0,2,0,2,0
有效,2,1,0,1,0,0
有没有,2,1,1,1,1,0
责任,2,0,2,0,2,0
创作,2,0,2,0,2,0
几岁,2,1,1,1,1,0
刘学洲,2,0,2,0,2,0
贵阳,2,0,2,0,2,0
出路,2,2,0,2,0,0
赋予,2,1,1,1,1,0
期待,2,0,2,0,2,0
出事,2,0,2,0,2,0
说起来,2,1,1,1,1,0
来生,2,0,2,0,2,0
冷,2,0,2,0,2,0
替,2,0,2,0,2,0
压抑,2,2,1,1,0,1
梦,2,1,2,0,1,1
根本,2,2,0,2,0,0
起码,2,0,2,0,2,0
即使,2,0,2,0,2,0
起来,2,1,1,1,1,0
讲,2,2,2,0,0,2
曾经,2,0,2,0,2,0
讽刺,2,1,1,1,1,0
农历生日,2,0,2,0,2,0
来说,2,1,1,1,1,0
树林,2,0,0,0,0,0
黑暗,2,0,2,0,2,0
树,2,0,1,0,1,0
千万不要,2,0,2,0,2,0
最后一次,2,1,1,1,1,0
决绝,2,0,2,0,2,0
说不定,2,0,1,0,1,0
说什么,2,0,1,0,1,0
北京,2,0,2,0,2,0
无法,2,2,1,1,0,1
还要,2,1,1,1,1,0
●,2,0,2,0,2,0
没有办法,2,0,2,0,2,0
没有了,2,1,1,1,1,0
没想到,2,0,1,0,1,0
胖,2,1,1,1,1,0
救赎,2,0,1,0,1,0
唤醒,2,1,1,1,1,0
胎,2,0,2,0,2,0
撑,2,1,1,1,1,0
放,2,0,1,0,1,0
风格,2,0,2,0,2,0
停止,2,0,2,0,2,0
方面,2,0,1,0,1,0
哥们,2,0,2,0,2,0
??,2,0,0,0,0,0
周遭,2,2,0,2,0,0
边,2,0,2,0,2,0
吵架,2,0,2,0,2,0
颤抖,2,2,2,0,0,2
轮回,2,1,1,1,1,0
喔,2,0,2,0,2,0
偷偷,2,0,2,0,2,0
在于,2,2,0,2,0,0
治疗,2,2,0,2,0,0
没钱,2,2,0,2,0,0
信息,2,0,0,0,0,0
一只,2,1,1,1,1,0
收到,2,1,2,0,1,1
肯定,2,1,1,1,1,0
默默,1,1,0,1,0,0
顺顺利利,1,1,0,1,0,0
特别,1,0,1,0,1,0
狗,1,0,1,0,1,0
特立独行,1,1,0,1,0,0
来得及,1,1,0,1,0,0
物质,1,1,0,1,0,0
没见过,1,0,1,0,1,0
狠,1,0,1,0,1,0
默想,1,1,0,1,0,0
顾及,1,1,1,0,0,1
牛肉,1,0,1,0,1,0
牛肉粉,1,0,1,0,1,0
民大,1,1,0,1,0,0
重视,1,0,1,0,1,0
没有错,1,0,1,0,1,0
爱过,1,1,0,1,0,0
校园暴力,1,0,1,0,1,0
海平面,1,0,1,0,1,0
爱情,1,1,0,1,0,0
爱意,1,0,1,0,1,0
树洞,1,0,1,0,1,0
没有做错,1,0,1,0,1,0
海域,1,0,0,0,0,0
预判,1,0,0,0,0,0
银杏黄,1,1,0,1,0,0
黄昏,1,1,1,0,0,1
片子,1,0,1,0,1,0
没有用,1,1,0,1,0,0
钱,1,1,0,1,0,0
查到,1,0,0,0,0,0
重返,1,1,0,1,0,0
查,1,0,1,0,1,0
爸爸妈妈,1,0,1,0,1,0
某一天,1,1,0,1,0,0
浪漫主义,1,1,0,1,0,0
极乐,1,0,1,0,1,0
独居青年,1,1,1,0,0,1
独自,1,0,1,0,1,0
独特,1,0,1,0,1,0
班上,1,0,1,0,1,0
派出所,1,0,0,0,0,0
采风,1,0,1,0,1,0
现金,1,0,0,0,0,0
?,1,1,0,1,0,0
班,1,0,1,0,1,0
朱家尖,1,0,0,0,0,0
注定,1,1,0,1,0,0
本质,1,1,0,1,0,0
醒来,1,1,0,1,0,0
活?,1,1,0,1,0,0
本来,1,0,1,0,1,0
理会,1,1,0,1,0,0
独生子女,1,1,0,1,0,0
注重,1,0,1,0,1,0
活得,1,1,1,0,0,1
理由,1,1,0,1,0,0
醒了,1,0,1,0,1,0
本人,1,0,0,0,0,0
?,1,1,0,1,0,0
配合,1,0,0,0,0,0
顺序,1,0,1,0,1,0
理解,1,0,1,0,1,0
泪流满面,1,1,0,1,0,0
甜甜,1,0,1,0,1,0
?,1,0,1,0,1,0
朵,1,0,1,0,1,0
顺遂,1,0,1,0,1,0
现代,1,1,0,1,0,0
重要,1,1,0,1,0,0
独立,1,1,0,1,0,0
顺利,1,1,1,0,0,1
猜,1,0,1,0,1,0
治病,1,1,0,1,0,0
沾染,1,0,1,0,1,0
猫咪,1,0,1,0,1,0
鼓楼,1,0,1,0,1,0
献上,1,0,1,0,1,0
流言蜚语,1,0,1,0,1,0
泡泡,1,0,1,0,1,0
???????????,1,0,1,0,1,0
重症,1,0,1,0,1,0
重新继续下去,1,1,0,1,0,0
流泪,1,0,1,0,1,0
流光溢彩,1,0,1,0,1,0
?,1,1,0,1,0,0
机票,1,0,0,0,0,0
玩弄,1,1,0,1,0,0
机关,1,0,0,0,0,0
泡泡机,1,0,1,0,1,0
玩耍,1,0,1,0,1,0
?,1,0,0,0,0,0
麻木,1,0,1,0,1,0
海浪,1,0,1,0,1,0
锅底,1,0,1,0,1,0
难以忍受,1,1,0,1,0,0
清洗,1,0,1,0,1,0
香甜,1,0,1,0,1,0
滴,1,0,1,0,1,0
沉浮,1,1,1,0,0,1
饱腹,1,0,1,0,1,0
沙滩,1,0,1,0,1,0
清晨,1,1,1,0,0,1
残酷温暖,1,1,0,1,0,0
火,1,1,0,1,0,0
飘摇,1,1,0,1,0,0
风雨中,1,1,0,1,0,0
风起云涌,1,0,1,0,1,0
爬上爬下,1,1,0,1,0,0
随心所欲,1,0,1,0,1,0
添麻烦,1,1,0,1,0,0
死掉,1,0,1,0,1,0
深陷,1,0,1,0,1,0
陷于,1,1,0,1,0,0
深秋,1,0,1,0,1,0
此时此刻,1,0,1,0,1,0
灿烂,1,0,1,0,1,0
没什么,1,0,1,0,1,0
深切,1,1,0,1,0,0
正月廿一,1,0,1,0,1,0
滨江区,1,0,0,0,0,0
满足,1,0,1,0,1,0
清秀,1,0,1,0,1,0
汤,1,0,0,0,0,0
毫无,1,1,0,1,0,0
难处,1,1,0,1,0,0
毫不,1,0,1,0,1,0
毕竟,1,0,1,0,1,0
毕业,1,0,1,0,1,0
雪地,1,1,1,0,0,1
比较好,1,1,1,0,0,1
比较大,1,0,0,0,0,0
需求,1,1,0,1,0,0
游戏,1,0,1,0,1,0
渣,1,1,0,1,0,0
滋生,1,1,1,0,0,1
比如,1,0,1,0,1,0
滑冰,1,0,1,0,1,0
满,1,0,1,0,1,0
满心,1,0,1,0,1,0
气温,1,0,1,0,1,0
满脸,1,0,1,0,1,0
求,1,0,0,0,0,0
满腔,1,1,0,1,0,0
求求,1,0,1,0,1,0
清蒸,1,0,1,0,1,0
江苏海洋,1,1,0,1,0,0
点心,1,0,1,0,1,0
魔力,1,0,1,0,1,0
正是,1,1,0,1,0,0
鲜艳,1,0,1,0,1,0
鲜血,1,0,1,0,1,0
樱花树下,1,1,0,1,0,0
樱花,1,1,0,1,0,0
颜色,1,1,0,1,0,0
鸳鸯,1,0,1,0,1,0
模仿,1,1,0,1,0,0
概念,1,1,0,1,0,0
面对,1,1,1,0,0,1
消失,1,0,1,0,1,0
没有人,1,1,0,1,0,0
海面,1,0,1,0,1,0
熬,1,0,1,0,1,0
镜头,1,0,1,0,1,0
海里,1,1,0,1,0,0
都一样,1,1,0,1,0,0
面试,1,0,1,0,1,0
题材,1,0,1,0,1,0
难熬,1,1,0,1,0,0
错位感,1,0,1,0,1,0
题,1,0,1,0,1,0
顺便,1,0,1,0,1,0
爆,1,0,1,0,1,0
样子,1,0,1,0,1,0
照相,1,0,1,0,1,0
欣赏,1,0,1,0,1,0
陪着,1,0,1,0,1,0
没有一个人,1,0,1,0,1,0
正宗,1,0,1,0,1,0
除夕,1,0,1,0,1,0
洋芋粑粑,1,0,1,0,1,0
鲈鱼,1,0,1,0,1,0
欺负,1,1,0,1,0,0
欲望,1,1,0,1,0,0
热情,1,0,1,0,1,0
热烈,1,0,1,0,1,0
阿,1,0,0,0,0,0
阶级,1,1,0,1,0,0
闻闻,1,0,1,0,1,0
没出息,1,0,1,0,1,0
闻着,1,0,1,0,1,0
没变,1,1,0,1,0,0
青春,1,0,1,0,1,0
消逝,1,1,0,1,0,0
焦虑,1,0,1,0,1,0
闲散,1,0,1,0,1,0
然而,1,1,0,1,0,0
照,1,0,1,0,1,0
长远,1,1,0,1,0,0
鲜红,1,0,1,0,1,0
青青,1,1,0,1,0,0
洋溢,1,0,1,0,1,0
赞同,1,1,0,1,0,0
生前,1,0,0,0,0,0
自拍,1,0,1,0,1,0
躯,1,0,1,0,1,0
车,1,0,1,0,1,0
至少,1,1,1,0,0,1
至关重要,1,1,0,1,0,0
至,1,0,1,0,1,0
自闭,1,1,0,1,0,0
自行,1,0,1,0,1,0
自由,1,0,1,0,1,0
自我感动,1,0,1,0,1,0
舅妈,1,0,1,0,1,0
自愈,1,1,1,0,0,1
车票,1,0,0,0,0,0
自在,1,0,1,0,1,0
自卑,1,1,0,1,0,0
自信,1,0,1,0,1,0
脚印,1,0,1,0,1,0
转世投胎,1,0,1,0,1,0
脖子,1,0,1,0,1,0
舅,1,0,1,0,1,0
舍得,1,0,1,0,1,0
脆弱,1,1,0,1,0,0
身材平平,1,0,1,0,1,0
落雪,1,0,1,0,1,0
落泪,1,0,1,0,1,0
萧山警局,1,0,0,0,0,0
身故,1,0,1,0,1,0
萤萤,1,1,0,1,0,0
苦难,1,0,1,0,1,0
苦海,1,0,1,0,1,0
苦头,1,1,0,1,0,0
身躯,1,0,1,0,1,0
舒服,1,1,0,1,0,0
若,1,0,1,0,1,0
花香,1,0,1,0,1,0
花,1,1,0,1,0,0
芋儿鸡,1,0,1,0,1,0
节点,1,1,0,1,0,0
艺术,1,0,1,0,1,0
舟山岛,1,0,0,0,0,0
身边,1,1,0,1,0,0
转发,1,0,1,0,1,0
能看到,1,0,1,0,1,0
身为,1,0,1,0,1,0
过敏    ,1,1,0,1,0,0
聊,1,0,1,0,1,0
而来,1,1,0,1,0,0
而是,1,1,0,1,0,0
而已,1,0,0,0,0,0
过后,1,0,1,0,1,0
而又,1,1,0,1,0,0
而且,1,0,1,0,1,0
过敏   ,1,1,0,1,0,0
者,1,0,1,0,1,0
聊聊,1,0,1,0,1,0
老弟,1,0,1,0,1,0
过敏体质,1,1,0,1,0,0
老人家,1,0,1,0,1,0
老乡,1,0,1,0,1,0
过生日,1,0,1,0,1,0
翻着,1,0,1,0,1,0
迈向,1,0,1,0,1,0
羞耻,1,0,1,0,1,0
聊天,1,0,1,0,1,0
聊聊天,1,0,1,0,1,0
能有,1,0,1,0,1,0
肾衰竭,1,0,1,0,1,0
转发微博,1,1,0,1,0,0
转角处,1,0,0,0,0,0
能力不足,1,1,0,1,0,0
胶片机,1,0,1,0,1,0
胜利,1,0,1,0,1,0
轻易,1,0,1,0,1,0
轻松,1,1,1,0,0,1
肿,1,0,1,0,1,0
肾移植,1,0,1,0,1,0
辽阔,1,0,0,0,0,0
轻生,1,1,0,1,0,0
肮脏,1,0,1,0,1,0
肚子,1,0,1,0,1,0
聚成,1,0,1,0,1,0
聚,1,0,1,0,1,0
辛苦,1,0,1,0,1,0
辱骂,1,0,1,0,1,0
联,1,0,1,0,1,0
身体,1,0,1,0,1,0
蓝猫,1,1,0,1,0,0
生命??,1,0,0,0,0,0
走饭,1,0,1,0,1,0
走夜路,1,0,1,0,1,0
读,1,0,1,0,1,0
诶,1,0,1,0,1,0
说过,1,0,0,0,0,0
说起,1,1,0,1,0,0
说实话,1,0,1,0,1,0
说出来,1,0,1,0,1,0
说不完,1,1,0,1,0,0
语言,1,1,0,1,0,0
读到,1,0,1,0,1,0
详细,1,0,1,0,1,0
试着,1,0,1,0,1,0
赶快,1,0,1,0,1,0
词条,1,1,0,1,0,0
诉说,1,0,1,0,1,0
访客,1,0,1,0,1,0
设身处地,1,1,1,0,0,1
许,1,0,1,0,1,0
读书,1,1,0,1,0,0
读完,1,0,1,0,1,0
记录,1,0,1,0,1,0
负能量,1,0,1,0,1,0
赌气,1,0,1,0,1,0
赞美,1,1,0,1,0,0
赤贫,1,1,0,1,0,0
走出,1,1,0,1,0,0
贫穷,1,1,0,1,0,0
负面,1,0,1,0,1,0
走出阴影,1,0,1,0,1,0
走后,1,0,1,0,1,0
豆米火锅,1,0,1,0,1,0
读懂,1,1,0,1,0,0
走向死亡,1,0,1,0,1,0
谢谢谢谢,1,0,0,0,0,0
谎言,1,1,0,1,0,0
谈恋爱,1,1,0,1,0,0
谈天说地,1,1,0,1,0,0
调侃,1,1,0,1,0,0
谁,1,0,1,0,1,0
课堂,1,0,1,0,1,0
起,1,0,1,0,1,0
记住,1,1,1,0,0,1
藉慰,1,0,1,0,1,0
行走,1,1,0,1,0,0
被迫,1,1,0,1,0,0
被欺负,1,0,1,0,1,0
被封,1,1,0,1,0,0
跌倒,1,1,0,1,0,0
被动,1,1,0,1,0,0
跑,1,0,1,0,1,0
表达出,1,0,1,0,1,0
街边,1,1,0,1,0,0
跑来,1,0,1,0,1,0
要不,1,0,0,0,0,0
行不行,1,0,1,0,1,0
血迹,1,0,1,0,1,0
距离,1,0,1,0,1,0
跨越,1,1,0,1,0,0
路口,1,0,1,0,1,0
路过,1,1,0,1,0,0
虽,1,0,1,0,1,0
虚荣,1,1,1,0,0,1
足以,1,1,0,1,0,0
要求,1,1,1,0,0,1
记不清,1,1,0,1,0,0
超级好,1,0,1,0,1,0
让人失望,1,1,0,1,0,0
认真,1,0,1,0,1,0
趁,1,1,0,1,0,0
警示,1,0,0,0,0,0
超棒,1,0,1,0,1,0
警官,1,0,0,0,0,0
言语暴力,1,1,0,1,0,0
超级可爱,1,1,0,1,0,0
解答,1,0,1,0,1,0
趟,1,0,1,0,1,0
解决问题,1,1,0,1,0,0
角度,1,1,0,1,0,0
越,1,1,0,1,0,0
觉,1,0,1,0,1,0
视频,1,0,1,0,1,0
越来越好,1,0,1,0,1,0
见过,1,0,1,0,1,0
越穷,1,1,0,1,0,0
还好,1,1,0,1,0,0
美妙,1,0,1,0,1,0
美丽,1,0,1,0,1,0
道森哥,1,0,1,0,1,0
看好,1,0,1,0,1,0
看不起,1,1,0,1,0,0
看一看,1,0,1,0,1,0
道森   ,1,1,0,1,0,0
相顾,1,0,1,0,1,0
道森   过敏,1,1,0,1,0,0
相差,1,0,1,0,1,0
道森午安,1,0,1,0,1,0
相像,1,0,1,0,1,0
看开,1,0,1,0,1,0
遗憾,1,0,1,0,1,0
相信自己,1,0,1,0,1,0
相信,1,0,1,0,1,0
遭受,1,0,1,0,1,0
相互,1,0,1,0,1,0
直到,1,1,0,1,0,0
目睹,1,1,0,1,0,0
目标,1,1,0,1,0,0
道,1,0,1,0,1,0
赚到钱,1,1,0,1,0,0
避免不了,1,1,0,1,0,0
真的可以,1,0,1,0,1,0
追求,1,0,1,0,1,0
知道吗,1,0,1,0,1,0
退租,1,0,0,0,0,0
矛盾,1,1,0,1,0,0
瞬间,1,0,1,0,1,0
着想,1,0,1,0,1,0
眼光,1,1,0,1,0,0
逃离现实,1,0,1,0,1,0
逃避,1,0,1,0,1,0
遍,1,1,0,1,0,0
真是,1,0,0,0,0,0
真想,1,1,0,1,0,0
看过,1,0,1,0,1,0
透析,1,0,1,0,1,0
看笑话,1,0,1,0,1,0
通知,1,0,0,0,0,0
逻辑,1,0,1,0,1,0
看海,1,0,1,0,1,0
遮掉,1,0,1,0,1,0
皱纹,1,0,1,0,1,0
网络暴力,1,0,1,0,1,0
生病,1,1,0,1,0,0
那句话,1,0,1,0,1,0
那天,1,1,0,1,0,0
男人,1,0,1,0,1,0
那时候,1,1,0,1,0,0
那条,1,0,0,0,0,0
用户,1,0,1,0,1,0
用心,1,1,0,1,0,0
用尽全力,1,0,1,0,1,0
那样,1,0,1,0,1,0
画展,1,0,1,0,1,0
那样的人,1,1,0,1,0,0
生生不息,1,0,1,0,1,0
那段时间,1,0,1,0,1,0
生理,1,0,1,0,1,0
生日愿望,1,0,1,0,1,0
生性,1,1,1,0,0,1
生命里,1,1,0,1,0,0
郁闷,1,0,1,0,1,0
画,1,0,1,0,1,0
那几年,1,1,0,1,0,0
邀请,1,0,1,0,1,0
瘦小,1,0,1,0,1,0
皮皮时光机,1,0,0,0,0,0
那一刻,1,0,1,0,1,0
的确,1,0,1,0,1,0
的事情可不可以发生在我身上,1,0,1,0,1,0
白眼,1,1,0,1,0,0
那个家,1,1,0,1,0,0
白发,1,0,1,0,1,0
癌症,1,1,0,1,0,0
痛楚,1,0,1,0,1,0
画画,1,0,1,0,1,0
痛哭,1,1,0,1,0,0
痛,1,1,0,1,0,0
留言,1,1,0,1,0,0
留疤,1,1,0,1,0,0
留守,1,1,0,1,0,0
留在,1,0,1,0,1,0
留下,1,0,1,0,1,0
画面,1,0,1,0,1,0
短线,1,1,0,1,0,0
研究生,1,0,1,0,1,0
确认,1,0,1,0,1,0
系列,1,0,1,0,1,0
繁星,1,1,1,0,0,1
累积,1,0,1,0,1,0
累,1,1,0,1,0,0
紧紧抓住,1,0,1,0,1,0
紧紧,1,0,1,0,1,0
这两天,1,0,1,0,1,0
素昧平生,1,0,1,0,1,0
这么个,1,1,0,1,0,0
这些人,1,0,0,0,0,0
组,1,0,1,0,1,0
糟糕,1,0,1,0,1,0
糖葫芦,1,0,1,0,1,0
这位,1,0,1,0,1,0
糖炒栗子,1,0,1,0,1,0
这几天,1,0,1,0,1,0
精神,1,1,0,1,0,0
这只,1,1,0,1,0,0
精彩,1,0,1,0,1,0
纯白,1,0,1,0,1,0
终,1,0,1,0,1,0
确诊,1,0,1,0,1,0
绝望,1,1,0,1,0,0
网络,1,0,1,0,1,0
网易云,1,0,1,0,1,0
网友,1,1,0,1,0,0
缺少,1,1,0,1,0,0
编号,1,0,1,0,1,0
还是一下,1,0,1,0,1,0
继续做,1,0,1,0,1,0
绝望感,1,1,0,1,0,0
绝对,1,0,1,0,1,0
终归,1,1,1,0,0,1
绚烂,1,0,1,0,1,0
这一世,1,0,1,0,1,0
这一切,1,1,1,0,0,1
结局,1,0,1,0,1,0
结尾,1,1,0,1,0,0
这一生,1,0,1,0,1,0
终身,1,0,1,0,1,0
终点,1,0,1,0,1,0
算作,1,0,1,0,1,0
这回,1,0,1,0,1,0
这期间,1,0,0,0,0,0
迷茫,1,0,1,0,1,0
这首歌,1,0,1,0,1,0
秋天,1,0,1,0,1,0
进来,1,0,1,0,1,0
神权,1,0,1,0,1,0
连接,1,0,1,0,1,0
神奇,1,0,1,0,1,0
神仙,1,0,1,0,1,0
神,1,0,1,0,1,0
祝福你,1,0,1,0,1,0
这条,1,0,0,0,0,0
祝福,1,1,0,1,0,0
追梦,1,1,1,0,0,1
祈求,1,0,1,0,1,0
祈愿,1,0,0,0,0,0
磨难,1,0,1,0,1,0
碰上,1,1,0,1,0,0
碑,1,0,1,0,1,0
碎碎恋,1,0,1,0,1,0
秘密,1,0,1,0,1,0
租房,1,0,0,0,0,0
稀里哗啦,1,1,0,1,0,0
稳定,1,1,0,1,0,0
简历,1,0,1,0,1,0
第七天,1,0,1,0,1,0
第一时间,1,0,0,0,0,0
第一天,1,1,0,1,0,0
第一位,1,0,1,0,1,0
第一,1,0,1,0,1,0
笑,1,0,1,0,1,0
竟,1,0,1,0,1,0
立马,1,0,1,0,1,0
这次,1,0,1,0,1,0
立涛,1,0,1,0,1,0
窘迫,1,0,1,0,1,0
这篇,1,0,1,0,1,0
窗外,1,0,1,0,1,0
突然想起来,1,0,1,0,1,0
空无一人,1,0,1,0,1,0
穷酸,1,1,0,1,0,0
服药,1,0,1,0,1,0
      ,1,1,0,1,0,0
有限,1,1,0,1,0,0
包裹,1,1,1,0,0,1
包容,1,0,1,0,1,0
勇者,1,0,1,0,1,0
勇气,1,0,1,0,1,0
动物,1,1,0,1,0,0
动不动,1,1,0,1,0,0
加点,1,0,1,0,1,0
办法,1,0,0,0,0,0
劝,1,0,1,0,1,0
前行,1,1,0,1,0,0
前几天,1,0,1,0,1,0
前世今生,1,1,0,1,0,0
前世,1,0,1,0,1,0
前,1,0,1,0,1,0
剁,1,0,1,0,1,0
刺眼,1,0,1,0,1,0
别让,1,0,1,0,1,0
别找,1,1,0,1,0,0
初中,1,1,0,1,0,0
初,1,0,1,0,1,0
创造,1,0,1,0,1,0
刚,1,0,0,0,0,0
出门走走,1,0,1,0,1,0
出警,1,0,0,0,0,0
包袱,1,1,1,0,0,1
化作,1,1,0,1,0,0
出来,1,0,1,0,1,0
化身,1,0,1,0,1,0
即时,1,0,0,0,0,0
即便,1,0,1,0,1,0
印象,1,0,1,0,1,0
卧槽,1,0,1,0,1,0
占卜,1,0,1,0,1,0
博主大,1,1,0,1,0,0
博主,1,0,1,0,1,0
南沙,1,0,0,0,0,0
单亲家庭,1,1,0,1,0,0
协助,1,0,0,0,0,0
半年,1,1,1,0,0,1
半夜,1,1,0,1,0,0
半,1,0,1,0,1,0
午夜,1,1,1,0,0,1
千万,1,0,1,0,1,0
十月廿四,1,0,1,0,1,0
十恶不赦,1,1,0,1,0,0
十年,1,0,1,0,1,0
十岁,1,0,1,0,1,0
十二月新,1,0,1,0,1,0
医院,1,0,1,0,1,0
医疗岗,1,1,0,1,0,0
区别,1,1,0,1,0,0
出色,1,0,1,0,1,0
出去,1,1,1,0,0,1
坟墓,1,0,0,0,0,0
公司,1,0,1,0,1,0
公主,1,1,0,1,0,0
八天,1,1,0,1,0,0
全市,1,0,0,0,0,0
全家人,1,0,1,0,1,0
全,1,0,1,0,1,0
入职,1,0,1,0,1,0
免费,1,0,1,0,1,0
光明,1,0,1,0,1,0
光亮,1,0,0,0,0,0
先生,1,0,1,0,1,0
兄弟,1,0,1,0,1,0
允许,1,0,1,0,1,0
像极,1,0,1,0,1,0
像是,1,1,0,1,0,0
偶尔,1,0,0,0,0,0
停留,1,0,1,0,1,0
停下来,1,1,1,0,0,1
停,1,0,1,0,1,0
做错,1,1,0,1,0,0
做梦,1,1,0,1,0,0
做出来,1,0,1,0,1,0
假装,1,1,0,1,0,0
假如,1,0,1,0,1,0
公交车上,1,0,1,0,1,0
共同话题,1,0,1,0,1,0
凡人,1,0,1,0,1,0
关,1,0,0,0,0,0
几条,1,0,0,0,0,0
几回,1,0,1,0,1,0
几千字,1,1,0,1,0,0
几十万,1,0,1,0,1,0
几乎,1,0,1,0,1,0
几个月,1,0,1,0,1,0
几个,1,1,0,1,0,0
准备,1,0,1,0,1,0
冷吗,1,1,0,1,0,0
决不,1,0,1,0,1,0
冬天,1,0,1,0,1,0
写过,1,1,0,1,0,0
写成,1,0,1,0,1,0
写很多,1,0,1,0,1,0
写下,1,1,0,1,0,0
写,1,0,1,0,1,0
再说,1,0,1,0,1,0
再生,1,1,0,1,0,0
再也不,1,0,1,0,1,0
再三,1,1,0,1,0,0
内心深处,1,0,1,0,1,0
其他,1,0,0,0,0,0
关于,1,1,0,1,0,0
历劫,1,0,1,0,1,0
压,1,1,1,0,0,1
厚脸皮,1,0,1,0,1,0
喜悦,1,0,1,0,1,0
啤酒肚,1,0,1,0,1,0
啊啊啊依稀,1,0,0,0,0,0
啊啊,1,0,0,0,0,0
哭死,1,0,1,0,1,0
哪里有,1,0,1,0,1,0
哪有,1,1,0,1,0,0
哪怕,1,0,0,0,0,0
哪吗,1,0,0,0,0,0
哪,1,0,1,0,1,0
哥,1,0,1,0,1,0
哎     ,1,1,0,1,0,0
哎,1,1,0,1,0,0
咽炎,1,1,0,1,0,0
和你一样,1,0,1,0,1,0
命题,1,1,0,1,0,0
命运,1,1,0,1,0,0
命,1,0,1,0,1,0
味道,1,0,1,0,1,0
周围,1,0,1,0,1,0
呐,1,0,1,0,1,0
呆,1,0,1,0,1,0
吹泡泡,1,0,1,0,1,0
吸引,1,0,1,0,1,0
善意,1,0,1,0,1,0
喧闹,1,0,0,0,0,0
原,1,0,1,0,1,0
嗨,1,0,1,0,1,0
坎坷,1,0,1,0,1,0
地球,1,0,1,0,1,0
地址,1,0,0,0,0,0
地上,1,0,1,0,1,0
在那里,1,0,1,0,1,0
在这里,1,0,1,0,1,0
在乎,1,0,1,0,1,0
圣诞树,1,0,1,0,1,0
土壤,1,0,1,0,1,0
图,1,0,0,0,0,0
园,1,0,1,0,1,0
回顾,1,1,1,0,0,1
回答,1,1,0,1,0,0
回看,1,0,1,0,1,0
回来了,1,0,1,0,1,0
回望,1,1,0,1,0,0
回报,1,0,1,0,1,0
回忆,1,0,1,0,1,0
回家,1,0,1,0,1,0
回头,1,0,1,0,1,0
四年前,1,1,0,1,0,0
四,1,0,1,0,1,0
嘴巴,1,0,1,0,1,0
吵闹,1,0,1,0,1,0
听过,1,0,1,0,1,0
听说过,1,0,1,0,1,0
含泪,1,0,1,0,1,0
变好,1,0,1,0,1,0
变,1,0,1,0,1,0
受苦,1,0,1,0,1,0
受累,1,0,1,0,1,0
取得,1,0,0,0,0,0
取名,1,0,1,0,1,0
发芽,1,1,1,0,0,1
发给,1,1,1,0,0,1
发信息,1,0,1,0,1,0
反抗,1,1,0,1,0,0
反复,1,0,1,0,1,0
友情,1,1,0,1,0,0
友好,1,0,1,0,1,0
又有,1,0,1,0,1,0
又不,1,1,0,1,0,0
又一次,1,1,0,1,0,0
去游乐场,1,0,1,0,1,0
去年,1,1,0,1,0,0
去向,1,0,0,0,0,0
去世,1,0,1,0,1,0
原生家庭,1,0,1,0,1,0
原因,1,0,1,0,1,0
原以为,1,0,0,0,0,0
变成,1,0,1,0,1,0
变身,1,0,1,0,1,0
句,1,0,1,0,1,0
吃饭,1,1,0,1,0,0
吝惜,1,1,0,1,0,0
吖,1,0,1,0,1,0
向,1,0,0,0,0,0
后面,1,0,1,0,1,0
后海,1,0,1,0,1,0
同时,1,0,1,0,1,0
同学们,1,0,1,0,1,0
合格,1,1,0,1,0,0
合作,1,0,1,0,1,0
各位,1,0,1,0,1,0
叽叽喳喳,1,0,1,0,1,0
另一种,1,1,0,1,0,0
司机,1,0,1,0,1,0
右边,1,0,0,0,0,0
可怕,1,1,0,1,0,0
可不可以,1,0,1,0,1,0
叭,1,0,1,0,1,0
叫做,1,0,1,0,1,0
只求,1,0,0,0,0,0
只剩,1,1,0,1,0,0
只会,1,1,0,1,0,0
另外,1,0,1,0,1,0
倾诉,1,1,0,1,0,0
倾听,1,1,0,1,0,0
倾向,1,1,0,1,0,0
上来,1,0,1,0,1,0
上层,1,0,0,0,0,0
上学,1,0,1,0,1,0
上去,1,0,1,0,1,0
上一次,1,1,0,1,0,0
三五年,1,1,0,1,0,0
三个人,1,1,0,1,0,0
三,1,0,1,0,1,0
七岁,1,1,0,1,0,0
七天,1,0,1,0,1,0
一颗,1,1,0,1,0,0
一顿,1,0,1,0,1,0
一道光,1,0,1,0,1,0
一起玩,1,0,1,0,1,0
一觉,1,1,0,1,0,0
一般,1,0,1,0,1,0
一组,1,0,1,0,1,0
一粒,1,1,0,1,0,0
一程,1,0,1,0,1,0
一种,1,0,1,0,1,0
一看,1,0,1,0,1,0
一滴,1,1,0,1,0,0
一段,1,0,1,0,1,0
一次又一次,1,0,1,0,1,0
上帝,1,1,0,1,0,0
上次,1,0,1,0,1,0
不想看,1,0,1,0,1,0
上海,1,0,0,0,0,0
不怕,1,1,0,1,0,0
不必要,1,0,1,0,1,0
不得了,1,0,1,0,1,0
不强求,1,1,1,0,0,1
不开心,1,0,1,0,1,0
不幸,1,0,1,0,1,0
不对,1,0,1,0,1,0
不容易,1,0,1,0,1,0
不嫌弃,1,1,0,1,0,0
不太,1,0,1,0,1,0
不在意,1,1,0,1,0,0
不善言辞,1,0,1,0,1,0
不到,1,0,1,0,1,0
不公平,1,0,1,0,1,0
不公,1,0,1,0,1,0
不做,1,0,1,0,1,0
不争气,1,0,1,0,1,0
下面,1,0,1,0,1,0
下雪,1,0,1,0,1,0
下沉,1,0,1,0,1,0
下来,1,0,1,0,1,0
上百次,1,0,1,0,1,0
上班,1,0,1,0,1,0
一束,1,1,1,0,0,1
一星期后,1,0,1,0,1,0
一时冲动,1,0,1,0,1,0
一整天,1,0,1,0,1,0
612小行星,1,0,1,0,1,0
5000-10000元,1,0,0,0,0,0
3,1,1,0,1,0,0
24岁,1,1,0,1,0,0
23岁,1,1,1,0,0,1
22号,1,0,0,0,0,0
2021年11月28日,1,0,1,0,1,0
2020年12月8日,1,0,1,0,1,0
2,1,1,0,1,0,0
1人,1,1,0,1,0,0
19年,1,0,1,0,1,0
180度,1,0,0,0,0,0
2016年11月23日,1,0,1,0,1,0
11月30号,1,0,1,0,1,0
11.28分,1,0,0,0,0,0
10岁,1,1,0,1,0,0
),1,0,1,0,1,0
(,1,0,1,0,1,0
  这个,1,1,0,1,0,0
  要是,1,1,1,0,0,1
  至少,1,1,1,0,0,1
  我,1,1,0,1,0,0
   你,1,1,1,0,0,1
616,1,0,1,0,1,0
9个,1,0,1,0,1,0
LDS,1,0,1,0,1,0
一个月,1,0,1,0,1,0
一度,1,1,1,0,0,1
一年多过,1,0,1,0,1,0
一年,1,0,1,0,1,0
一地鸡毛,1,1,0,1,0,0
一双,1,0,1,0,1,0
一半,1,1,1,0,0,1
一切都好,1,0,1,0,1,0
一切安好,1,0,1,0,1,0
一共,1,0,1,0,1,0
一会,1,0,1,0,1,0
一个星期,1,0,1,0,1,0
a,1,0,1,0,1,0
一丝丝,1,0,0,0,0,0
一丝,1,0,0,0,0,0
一世,1,0,1,0,1,0
祝,1,0,1,0,1,0
」,1,0,1,0,1,0
?,1,0,1,0,1,0
u,1,0,1,0,1,0
tm,1,0,0,0,0,0
icu,1,0,1,0,1,0
b,1,1,0,1,0,0
不想,1,0,0,0,0,0
不愿,1,0,1,0,1,0
借给,1,0,1,0,1,0
仔,1,1,0,1,0,0
从小到大,1,0,1,0,1,0
从头开始,1,1,0,1,0,0
从不,1,1,0,1,0,0
仍然不会,1,0,1,0,1,0
今年冬天,1,0,1,0,1,0
今天晚上,1,0,1,0,1,0
仅仅,1,0,0,0,0,0
什么样,1,1,0,1,0,0
什么原因,1,1,0,1,0,0
人间地狱,1,0,1,0,1,0
人烟稀少,1,0,0,0,0,0
人才,1,1,1,0,0,1
人心,1,1,0,1,0,0
人世间,1,0,1,0,1,0
亲生,1,0,0,0,0,0
亲人,1,0,1,0,1,0
亲,1,0,1,0,1,0
享受,1,1,0,1,0,0
产妇,1,1,0,1,0,0
交情,1,0,1,0,1,0
五官,1,0,1,0,1,0
互联网,1,0,1,0,1,0
互,1,0,0,0,0,0
从来没有,1,1,1,0,0,1
仙女,1,0,1,0,1,0
不懂事,1,0,1,0,1,0
代沟,1,0,1,0,1,0
倘若,1,1,0,1,0,0
修图,1,0,1,0,1,0
保护,1,0,1,0,1,0
侮辱,1,0,1,0,1,0
依旧,1,1,0,1,0,0
你的错,1,0,1,0,1,0
你我,1,0,1,0,1,0
何地,1,0,1,0,1,0
体验,1,0,1,0,1,0
体质   ,1,1,0,1,0,0
体会到,1,1,0,1,0,0
住校,1,1,0,1,0,0
住所,1,0,0,0,0,0
住在,1,1,0,1,0,0
低头,1,0,1,0,1,0
位,1,1,0,1,0,0
休息,1,0,1,0,1,0
企图,1,1,0,1,0,0
仿佛,1,1,0,1,0,0
任性,1,0,1,0,1,0
任何地方,1,1,0,1,0,0
以及,1,1,0,1,0,0
以前,1,0,1,0,1,0
于,1,1,0,1,0,0
二次,1,0,0,0,0,0
二十五岁,1,0,1,0,1,0
事物,1,0,1,0,1,0
两边,1,0,0,0,0,0
两百天,1,1,0,1,0,0
两朵,1,0,1,0,1,0
两年,1,1,0,1,0,0
两个月,1,0,1,0,1,0
丢掉,1,1,1,0,0,1
东荷嘉苑,1,0,0,0,0,0
东北,1,0,1,0,1,0
世俗,1,1,1,0,0,1
世人,1,0,1,0,1,0
与众不同,1,1,0,1,0,0
不需要,1,0,1,0,1,0
不通,1,0,1,0,1,0
不适,1,0,1,0,1,0
不贷,1,0,1,0,1,0
不要说,1,0,1,0,1,0
不要觉得,1,0,1,0,1,0
不要管,1,1,0,1,0,0
不给,1,1,0,1,0,0
不知,1,0,0,0,0,0
不满,1,0,1,0,1,0
不清醒,1,1,1,0,0,1
不放弃,1,0,1,0,1,0
两鬓,1,0,1,0,1,0
严惩,1,0,1,0,1,0
严重   ,1,1,0,1,0,0
乖乖,1,0,1,0,1,0
事件,1,0,1,0,1,0
事与愿违,1,0,1,0,1,0
争吵,1,1,0,1,0,0
了断,1,0,1,0,1,0
了不起,1,0,1,0,1,0
了    ,1,1,0,1,0,0
买菜,1,0,1,0,1,0
也曾,1,1,1,0,0,1
也想,1,0,1,0,1,0
也可以,1,0,1,0,1,0
乐观,1,1,0,1,0,0
个人,1,0,1,0,1,0
之类,1,0,1,0,1,0
之上,1,0,1,0,1,0
久,1,0,1,0,1,0
主要,1,0,1,0,1,0
主动,1,0,1,0,1,0
为什么不,1,0,1,0,1,0
临近,1,0,1,0,1,0
串串,1,0,1,0,1,0
中式学校教育,1,1,0,1,0,0
中学教师,1,0,1,0,1,0
坚定,1,1,0,1,0,0
垃圾,1,0,1,0,1,0
有问题,1,0,1,0,1,0
担心,1,1,1,0,0,1
抽出来,1,0,1,0,1,0
抵抗,1,1,1,0,0,1
抱着,1,0,1,0,1,0
抬头,1,0,1,0,1,0
折磨,1,0,1,0,1,0
抗争,1,0,1,0,1,0
抓着,1,0,1,0,1,0
抑郁,1,1,0,1,0,0
抑制,1,1,1,0,0,1
承接,1,0,1,0,1,0
找遍,1,0,0,0,0,0
找回,1,0,1,0,1,0
批评,1,0,1,0,1,0
扶持,1,0,1,0,1,0
扩,1,0,0,0,0,0
扛不住,1,1,0,1,0,0
打骂,1,1,0,1,0,0
打电话,1,0,0,0,0,0
才能,1,1,0,1,0,0
手里,1,0,1,0,1,0
手绘,1,0,1,0,1,0
手术费,1,0,1,0,1,0
扉,1,0,1,0,1,0
抽离感,1,0,1,0,1,0
拍摄,1,0,1,0,1,0
所有人,1,0,1,0,1,0
拍照片,1,0,1,0,1,0
推波助澜,1,0,0,0,0,0
控制,1,0,1,0,1,0
接近,1,0,1,0,1,0
接受现实,1,1,1,0,0,1
接下来,1,1,0,1,0,0
探讨,1,0,1,0,1,0
探寻,1,0,0,0,0,0
掉下来,1,0,1,0,1,0
换,1,0,1,0,1,0
捡到,1,1,0,1,0,0
捆绑,1,0,1,0,1,0
挺帅,1,0,1,0,1,0
挺,1,0,1,0,1,0
挨过来,1,1,0,1,0,0
挣钱,1,1,0,1,0,0
挑,1,1,0,1,0,0
按照,1,0,0,0,0,0
指责,1,1,0,1,0,0
指导,1,1,0,1,0,0
挂在嘴边,1,1,0,1,0,0
持续,1,0,0,0,0,0
拿着,1,0,1,0,1,0
拨打,1,0,1,0,1,0
所谓,1,0,1,0,1,0
       原来,1,1,0,1,0,0
城,1,1,1,0,0,1
想开,1,1,0,1,0,0
想不开,1,0,1,0,1,0
想不出来,1,1,0,1,0,0
惩罚,1,0,1,0,1,0
惨遭,1,0,1,0,1,0
情人,1,0,0,0,0,0
悲痛,1,0,1,0,1,0
悲剧性,1,1,0,1,0,0
患者,1,1,0,1,0,0
患得患失,1,1,1,0,0,1
悄然,1,1,1,0,0,1
悄悄地,1,0,1,0,1,0
恶性肿瘤,1,1,0,1,0,0
恶性循环,1,1,0,1,0,0
恶劣,1,1,0,1,0,0
恶,1,0,1,0,1,0
恳求,1,0,0,0,0,0
恰巧,1,0,1,0,1,0
恨不得,1,0,1,0,1,0
总能,1,0,1,0,1,0
总有,1,1,1,0,0,1
总归,1,0,1,0,1,0
总会,1,1,0,1,0,0
总,1,1,1,0,0,1
想尽,1,0,0,0,0,0
想说,1,1,1,0,0,1
房子,1,0,1,0,1,0
想象,1,0,1,0,1,0
战战兢兢,1,1,0,1,0,0
战,1,1,0,1,0,0
我爸爸,1,1,0,1,0,0
我们自己,1,1,0,1,0,0
我们家,1,1,0,1,0,0
我们大家,1,0,1,0,1,0
我们万分感谢,1,0,0,0,0,0
成,1,0,1,0,1,0
懵懵懂懂,1,1,0,1,0,0
懵懂,1,1,1,0,0,1
懦弱,1,1,0,1,0,0
慈善,1,0,1,0,1,0
愿望,1,0,1,0,1,0
愿意做,1,1,0,1,0,0
愧疚,1,1,0,1,0,0
感觉到,1,1,0,1,0,0
感动,1,0,1,0,1,0
感到,1,0,1,0,1,0
意识到,1,0,1,0,1,0
愉快,1,0,1,0,1,0
想问,1,0,1,0,1,0
想过,1,1,0,1,0,0
想起你,1,0,1,0,1,0
描述,1,0,1,0,1,0
提供,1,0,0,0,0,0
提前,1,0,0,0,0,0
更加,1,1,0,1,0,0
暴力,1,0,1,0,1,0
暖和,1,1,1,0,0,1
普通人,1,1,0,1,0,0
普通,1,0,1,0,1,0
晕染,1,0,1,0,1,0
昵称,1,0,0,0,0,0
是啥,1,1,0,1,0,0
是否,1,1,1,0,0,1
昨天晚上,1,0,1,0,1,0
昨天凌晨,1,0,1,0,1,0
昨天28号下午5:30,1,0,0,0,0,0
春游,1,1,0,1,0,0
星星,1,0,1,0,1,0
星光,1,0,1,0,1,0
明年3月,1,0,1,0,1,0
明天,1,0,1,0,1,0
时隔,1,0,1,0,1,0
时常,1,1,0,1,0,0
时不时,1,0,1,0,1,0
早知道,1,1,0,1,0,0
早点,1,0,1,0,1,0
早期,1,1,0,1,0,0
早上好,1,0,1,0,1,0
曙光,1,1,0,1,0,0
更好,1,0,1,0,1,0
搜,1,0,0,0,0,0
曾,1,1,0,1,0,0
有罪,1,0,1,0,1,0
有种,1,0,1,0,1,0
有神,1,0,1,0,1,0
有着,1,1,0,1,0,0
有点累,1,1,0,1,0,0
有朝一日,1,0,1,0,1,0
有意,1,1,1,0,0,1
有想法,1,0,0,0,0,0
有很多,1,0,1,0,1,0
有幸,1,0,1,0,1,0
有可能,1,0,1,0,1,0
有一天,1,1,1,0,0,1
最难,1,0,1,0,1,0
最近一次,1,0,0,0,0,0
最终,1,0,1,0,1,0
最深,1,1,0,1,0,0
最最,1,0,1,0,1,0
最新情况,1,0,0,0,0,0
最新,1,0,0,0,0,0
最好,1,0,1,0,1,0
最后面,1,0,1,0,1,0
最后一刻,1,0,1,0,1,0
最佳摄影,1,1,0,1,0,0
早上7点43分,1,0,1,0,1,0
早,1,0,0,0,0,0
日常,1,1,1,0,0,1
无辜,1,0,1,0,1,0
散心,1,0,1,0,1,0
敞,1,0,1,0,1,0
教育,1,1,0,1,0,0
救助,1,0,1,0,1,0
救,1,0,1,0,1,0
敏感,1,1,1,0,0,1
放过,1,0,1,0,1,0
放在,1,0,1,0,1,0
放到,1,1,0,1,0,0
改变现实,1,0,1,0,1,0
改变,1,1,0,1,0,0
改,1,0,1,0,1,0
收容,1,0,1,0,1,0
攀比,1,1,1,0,0,1
擅长,1,1,0,1,0,0
撒谎,1,1,0,1,0,0
撒,1,1,1,0,0,1
摇摆,1,1,1,0,0,1
摄影知识,1,0,1,0,1,0
摄影圈,1,0,0,0,0,0
摄影博主,1,0,1,0,1,0
搞,1,1,0,1,0,0
搜寻,1,0,0,0,0,0
散散心,1,0,1,0,1,0
散落,1,0,1,0,1,0
整天,1,1,0,1,0,0
无忧无虑,1,0,1,0,1,0
无论是,1,0,1,0,1,0
无论如何,1,1,0,1,0,0
无论何时,1,0,1,0,1,0
无解,1,1,0,1,0,0
无罪,1,0,1,0,1,0
无畏,1,1,0,1,0,0
无理取闹,1,0,1,0,1,0
无暇,1,0,1,0,1,0
无数,1,0,1,0,1,0
无惧,1,0,1,0,1,0
无奈,1,1,0,1,0,0
整颗,1,1,1,0,0,1
无处,1,0,1,0,1,0
无力,1,0,0,0,0,0
无休止,1,1,0,1,0,0
旅途,1,0,1,0,1,0
旅行,1,0,1,0,1,0
旁边,1,0,1,0,1,0
方向,1,0,0,0,0,0
新疆,1,0,1,0,1,0
断言,1,1,1,0,0,1
文字,1,0,1,0,1,0
急求,1,0,0,0,0,0
急急急谢谢,1,0,0,0,0,0
思考,1,1,0,1,0,0
安宁,1,1,1,0,0,1
它们,1,0,1,0,1,0
学生时代,1,0,1,0,1,0
学校,1,1,0,1,0,0
孤身一人,1,0,1,0,1,0
孤单,1,0,1,0,1,0
季节,1,0,1,0,1,0
孟婆汤,1,0,1,0,1,0
孟婆,1,0,0,0,0,0
存在,1,0,1,0,1,0
嫌弃,1,1,0,1,0,0
姨舅,1,0,1,0,1,0
姥姥姥爷姑姑,1,0,1,0,1,0
委屈,1,0,1,0,1,0
姑且,1,0,1,0,1,0
妄想,1,0,1,0,1,0
如此,1,0,1,0,1,0
如有,1,0,1,0,1,0
好难,1,0,1,0,1,0
好过,1,1,0,1,0,0
好累,1,1,0,1,0,0
好的,1,0,1,0,1,0
好烦      ,1,1,0,1,0,0
好想,1,1,0,1,0,0
守护,1,0,1,0,1,0
安静,1,0,1,0,1,0
小兄弟,1,0,1,0,1,0
完,1,0,1,0,1,0
小乌石塘,1,0,0,0,0,0
将,1,0,1,0,1,0
封,1,1,0,1,0,0
寿命,1,0,1,0,1,0
导致,1,1,0,1,0,0
寻人启事,1,0,0,0,0,0
对象,1,0,1,0,1,0
对于,1,1,0,1,0,0
对不起,1,0,1,0,1,0
寒夜,1,1,0,1,0,0
寄,1,0,1,0,1,0
容貌,1,0,1,0,1,0
容易,1,1,0,1,0,0
家暴,1,1,0,1,0,0
家庭教育,1,1,0,1,0,0
宣泄,1,0,1,0,1,0
审核,1,0,0,0,0,0
实施,1,1,0,1,0,0
宝宝,1,1,0,1,0,0
宝,1,0,1,0,1,0
定位,1,0,0,0,0,0
定,1,0,1,0,1,0
完全没必要,1,0,1,0,1,0
好快,1,1,1,0,0,1
好心,1,0,0,0,0,0
好多好多,1,1,0,1,0,0
好在,1,1,0,1,0,0
天花板,1,0,1,0,1,0
天气,1,1,1,0,0,1
天天,1,0,1,0,1,0
天呐,1,0,1,0,1,0
大部分,1,0,1,0,1,0
大病,1,1,0,1,0,0
大男孩,1,0,0,0,0,0
大概,1,1,0,1,0,0
大抵,1,1,1,0,0,1
大姐头,1,0,1,0,1,0
大伯,1,0,1,0,1,0
大了,1,0,1,0,1,0
多管闲事,1,0,1,0,1,0
多看一看,1,0,1,0,1,0
多吃,1,0,1,0,1,0
多个,1,0,0,0,0,0
外面,1,1,1,0,0,1
外婆,1,0,1,0,1,0
外地,1,1,0,1,0,0
处理,1,0,0,0,0,0
墓,1,0,1,0,1,0
城里,1,1,0,1,0,0
城郊,1,0,1,0,1,0
天黑,1,0,1,0,1,0
太大,1,1,0,1,0,0
太太,1,0,1,0,1,0
契机,1,1,0,1,0,0
好听,1,0,1,0,1,0
好吃我,1,0,1,0,1,0
好不好吃,1,1,1,0,0,1
她们,1,1,1,0,0,1
她,1,0,0,0,0,0
女儿,1,1,1,0,0,1
奥,1,0,1,0,1,0
奖励,1,0,0,0,0,0
奔涌,1,0,1,0,1,0
奔,1,1,0,1,0,0
奈何桥,1,0,1,0,1,0
太好了,1,0,1,0,1,0
夺不走,1,0,1,0,1,0
头疼,1,0,1,0,1,0
头发,1,0,1,0,1,0
头像,1,0,1,0,1,0
失眠,1,1,0,1,0,0
失望透顶,1,1,0,1,0,0
失望,1,0,1,0,1,0
太难,1,0,1,0,1,0
太累,1,0,1,0,1,0
太热,1,0,1,0,1,0
小于,1,0,1,0,1,0
小动物,1,0,1,0,1,0
怕,1,1,1,0,0,1
很有可能,1,0,0,0,0,0
很早,1,0,1,0,1,0
很少,1,0,1,0,1,0
很多年,1,0,1,0,1,0
很多天,1,0,1,0,1,0
很冷,1,0,1,0,1,0
很乖,1,1,0,1,0,0
很久以前,1,0,1,0,1,0
待在,1,1,1,0,0,1
往生,1,0,1,0,1,0
往前走,1,1,0,1,0,0
往前,1,1,1,0,0,1
往下,1,0,1,0,1,0
彻底,1,1,0,1,0,0
影响,1,1,0,1,0,0
当成,1,0,1,0,1,0
当地人,1,0,0,0,0,0
归零,1,1,0,1,0,0
归来,1,0,1,0,1,0
归宿,1,0,1,0,1,0
归位,1,0,1,0,1,0
强奸,1,1,0,1,0,0
弯路,1,1,0,1,0,0
引起,1,0,1,0,1,0
很早这篇,1,0,0,0,0,0
很穷,1,1,0,1,0,0
小哥哥,1,0,1,0,1,0
很糟糕,1,0,1,0,1,0
怎样了,1,1,0,1,0,0
怎么样,1,0,1,0,1,0
怀抱,1,0,1,0,1,0
念头,1,1,1,0,0,1
快快,1,0,0,0,0,0
忙,1,0,1,0,1,0
忘了,1,1,0,1,0,0
忘,1,0,1,0,1,0
忍耐,1,0,1,0,1,0
忍心,1,0,1,0,1,0
忍不住,1,0,1,0,1,0
心里话,1,0,1,0,1,0
心痛,1,1,0,1,0,0
心理暴力,1,1,0,1,0,0
心理寄托,1,1,0,1,0,0
心理,1,0,1,0,1,0
心想,1,0,1,0,1,0
心急如焚,1,0,0,0,0,0
心中,1,0,1,0,1,0
微笑,1,0,1,0,1,0
徒儿,1,0,0,0,0,0
很高,1,0,0,0,0,0
很苦,1,0,1,0,1,0
开花,1,1,1,0,0,1
开机,1,0,1,0,1,0
开朗,1,1,0,1,0,0
开始        ,1,1,0,1,0,0
巧,1,0,1,0,1,0
州,1,0,1,0,1,0
崩溃,1,1,0,1,0,0
山顶,1,0,0,0,0,0
山上,1,0,1,0,1,0
山,1,0,1,0,1,0
尽管,1,1,0,1,0,0
尽早,1,0,1,0,1,0
尽头,1,0,1,0,1,0
尽可能,1,1,0,1,0,0
就这样,1,0,1,0,1,0
就可以,1,0,1,0,1,0
就像,1,0,1,0,1,0
尘,1,1,0,1,0,0
小行星,1,0,1,0,1,0
小男孩,1,0,1,0,1,0
小洲,1,0,1,0,1,0
小晴天,1,0,1,0,1,0
小时候,1,1,0,1,0,0
小州,1,0,1,0,1,0
小孩儿,1,0,1,0,1,0
小学,1,1,0,1,0,0
小奶猫,1,0,1,0,1,0
巨,1,1,0,1,0,0
差不多,1,0,0,0,0,0
已经很久很久,1,1,0,1,0,0
年复一年,1,0,1,0,1,0
开到,1,0,1,0,1,0
康士坦,1,0,1,0,1,0
底线,1,1,0,1,0,0
库,1,0,1,0,1,0
幸运,1,0,1,0,1,0
幸好,1,1,0,1,0,0
并没有,1,0,1,0,1,0
并且,1,1,0,1,0,0
并不,1,1,0,1,0,0
年纪,1,1,1,0,0,1
年初,1,0,1,0,1,0
帅哥,1,0,1,0,1,0
年关,1,0,1,0,1,0
平淡,1,1,1,0,0,1
干脆,1,0,1,0,1,0
干嘛,1,0,1,0,1,0
常常,1,1,1,0,0,1
常在,1,0,1,0,1,0
席卷,1,0,1,0,1,0
带走,1,1,1,0,0,1
带来,1,1,0,1,0,0
带出,1,0,1,0,1,0
?,1,0,1,0,1,0
 ,0,0,0,4,7,4
