ID,Words,All,Tree Hole,Wailing Wall,Unique Tree Hole,Unique Wailing Wall,Both,Difference
红烧土豆叶,猫咪,35,1,34,1,34,0,94.28571428571428
红烧土豆叶,下辈子,25,2,24,1,23,1,84.61538461538461
红烧土豆叶,小,25,2,23,2,23,0,84.0
红烧土豆叶,同学,13,1,11,1,11,0,83.33333333333334
红烧土豆叶,昔书,32,3,29,2,28,1,81.25
红烧土豆叶,一只,30,4,27,3,26,1,74.19354838709677
红烧土豆叶,你,354,50,316,32,298,18,72.6775956284153
红烧土豆叶,温柔,11,2,10,1,9,1,66.66666666666666
红烧土豆叶,活着,11,2,9,2,9,0,63.63636363636363
红烧土豆叶,一定,26,5,22,4,21,1,62.96296296296296
红烧土豆叶,愿,16,3,13,3,13,0,62.5
红烧土豆叶,离开,14,3,12,2,11,1,60.0
红烧土豆叶,坚持,14,3,12,2,11,1,60.0
红烧土豆叶,如果,39,9,33,6,30,3,57.14285714285714
红烧土豆叶,猫,24,6,21,3,18,3,55.55555555555556
红烧土豆叶,微博,19,5,17,2,14,3,54.54545454545454
红烧土豆叶,写,11,3,9,2,8,1,50.0
红烧土豆叶,可以,25,7,20,5,18,2,48.14814814814815
红烧土豆叶,看到,42,13,35,7,29,6,45.83333333333333
红烧土豆叶,今天,20,6,16,4,14,2,45.45454545454545
红烧土豆叶,点,14,3,8,3,8,0,45.45454545454545
红烧土豆叶,”,13,4,10,3,9,1,42.85714285714285
红烧土豆叶,一个,34,10,25,8,23,2,42.85714285714285
红烧土豆叶,“,13,4,10,3,9,1,42.85714285714285
红烧土豆叶,哭,11,4,9,2,7,2,38.46153846153847
红烧土豆叶,世界,14,5,11,3,9,2,37.5
红烧土豆叶,你们,12,4,8,3,7,1,33.33333333333333
红烧土豆叶,不要,12,4,8,4,8,0,33.33333333333333
红烧土豆叶,再,14,5,10,4,9,1,33.33333333333333
红烧土豆叶,虽然,11,4,8,3,7,1,33.33333333333333
红烧土豆叶,一下,12,4,8,4,8,0,33.33333333333333
红烧土豆叶,但是,21,9,17,4,12,5,30.76923076923077
红烧土豆叶,得,19,7,13,6,12,1,30.0
红烧土豆叶,多,18,7,13,5,11,2,30.0
红烧土豆叶,我们,68,27,50,18,41,9,29.87012987012987
红烧土豆叶,走,16,6,11,4,9,2,29.411764705882355
红烧土豆叶,他们,15,5,9,4,8,1,28.57142857142857
红烧土豆叶,地,11,4,7,4,7,0,27.27272727272727
红烧土豆叶,记得,11,4,7,4,7,0,27.27272727272727
红烧土豆叶,为,16,7,12,3,8,4,26.31578947368421
红烧土豆叶,知道,17,7,12,3,8,4,26.31578947368421
红烧土豆叶,希望,62,25,42,17,34,8,25.37313432835821
红烧土豆叶,人,55,21,34,19,32,2,23.63636363636364
红烧土豆叶,成为,13,5,8,5,8,0,23.07692307692308
红烧土豆叶,那么,11,5,8,3,6,2,23.07692307692308
红烧土豆叶,时候,39,16,25,13,22,3,21.951219512195124
红烧土豆叶,上,18,8,12,6,10,2,20.0
红烧土豆叶,因为,14,6,9,5,8,1,20.0
红烧土豆叶,还在,18,8,12,6,10,2,20.0
红烧土豆叶,很多,17,7,10,7,10,0,17.647058823529413
红烧土豆叶,这么,16,7,10,6,9,1,17.647058823529413
红烧土豆叶,什么,16,7,10,6,9,1,17.647058823529413
红烧土豆叶,绝望,13,5,7,5,7,0,16.666666666666664
红烧土豆叶,感同身受,11,5,7,4,6,1,16.666666666666664
鹿道森,小,15,0,15,0,15,0,100.0
鹿道森,联系,12,0,2,0,2,0,100.0
鹿道森,作品,12,0,12,0,12,0,100.0
鹿道森,照顾,21,0,21,0,21,0,100.0
鹿道森,微博,20,0,17,0,17,0,100.0
鹿道森,道森,18,0,16,0,16,0,100.0
鹿道森,杭州,11,0,6,0,6,0,100.0
鹿道森,遇到,14,0,13,0,13,0,100.0
鹿道森,在那边,14,0,14,0,14,0,100.0
鹿道森,叫,15,0,15,0,15,0,100.0
鹿道森,舟山,15,0,8,0,8,0,100.0
鹿道森,去找,22,0,22,0,22,0,100.0
鹿道森,弟弟,23,1,22,1,22,0,91.30434782608695
鹿道森,玫瑰,37,2,36,1,35,1,89.47368421052632
鹿道森,年年,18,1,18,0,17,1,89.47368421052632
鹿道森,?,17,1,16,1,16,0,88.23529411764706
鹿道森,关注,19,1,16,1,16,0,88.23529411764706
鹿道森,记得,19,1,16,1,16,0,88.23529411764706
鹿道森,这么,15,1,13,1,13,0,85.71428571428571
鹿道森,刘学州,29,2,25,2,25,0,85.18518518518519
鹿道森,你,402,33,377,25,369,8,83.90243902439025
鹿道森,互相,12,1,11,1,11,0,83.33333333333334
鹿道森,那么,11,1,10,1,10,0,81.81818181818183
鹿道森,好好的,11,1,10,1,10,0,81.81818181818183
鹿道森,愿,19,2,18,1,17,1,80.0
鹿道森,多,12,1,9,1,9,0,80.0
鹿道森,你们,49,5,44,5,44,0,79.59183673469387
鹿道森,如果,28,3,22,2,21,1,76.0
鹿道森,我们,36,4,29,2,27,2,75.75757575757575
鹿道森,温柔,15,2,14,1,13,1,75.0
鹿道森,可以,27,3,21,2,20,1,75.0
鹿道森,一定要,19,2,14,1,13,1,75.0
鹿道森,找到,12,1,6,1,6,0,71.42857142857143
鹿道森,拍,13,2,11,2,11,0,69.23076923076923
鹿道森,美好,12,2,11,1,10,1,69.23076923076923
鹿道森,摄影,11,2,10,1,9,1,66.66666666666666
鹿道森,一下,17,2,10,2,10,0,66.66666666666666
鹿道森,朋友,36,4,19,3,18,1,65.21739130434783
鹿道森,幸福,21,4,19,2,17,2,65.21739130434783
鹿道森,他,132,18,85,16,83,2,65.0485436893204
鹿道森,快乐,18,3,14,3,14,0,64.70588235294117
鹿道森,为,32,6,28,4,26,2,64.70588235294117
鹿道森,平安,11,2,9,1,8,1,63.63636363636363
鹿道森,一起,11,2,9,2,9,0,63.63636363636363
鹿道森,今天,22,4,18,4,18,0,63.63636363636363
鹿道森,希望,69,12,52,12,52,0,62.5
鹿道森,一定,21,4,16,3,15,1,60.0
鹿道森,小鹿,16,3,12,3,12,0,60.0
鹿道森,离开,18,4,14,4,14,0,55.55555555555556
鹿道森,好,29,7,24,4,21,3,54.83870967741935
鹿道森,看到,25,5,17,4,16,1,54.54545454545454
鹿道森,永远,12,3,10,2,9,1,53.84615384615385
鹿道森,还有,17,4,13,3,12,1,52.94117647058824
鹿道森,一样,16,4,13,3,12,1,52.94117647058824
鹿道森,喜欢,17,4,12,4,12,0,50.0
鹿道森,一个,38,10,30,8,28,2,50.0
鹿道森,时候,15,4,12,3,11,1,50.0
鹿道森,把,11,3,9,2,8,1,50.0
鹿道森,好好,19,5,14,5,14,0,47.368421052631575
鹿道森,不知道,17,4,11,4,11,0,46.66666666666666
鹿道森,温暖,11,3,8,3,8,0,45.45454545454545
鹿道森,世界,47,13,34,12,33,1,44.680851063829785
鹿道森,爱,31,10,25,6,21,4,42.85714285714285
鹿道森,大家,18,5,12,3,10,2,41.17647058823529
鹿道森,上,12,3,7,3,7,0,40.0
鹿道森,用,11,3,7,3,7,0,40.0
鹿道森,还是,20,6,14,5,13,1,40.0
鹿道森,没有,27,8,18,8,18,0,38.46153846153847
鹿道森,请,15,4,9,3,8,1,38.46153846153847
鹿道森,很多,16,5,11,4,10,1,37.5
鹿道森,现在,21,6,13,4,11,2,36.84210526315789
鹿道森,已经,16,4,8,4,8,0,33.33333333333333
离灯_冬眠mode关闭失败,姐妹,22,3,19,2,18,1,72.72727272727273
离灯_冬眠mode关闭失败,方式,14,4,9,4,9,0,38.46153846153847
离灯_冬眠mode关闭失败,不知道,19,6,12,5,11,1,33.33333333333333
离灯_冬眠mode关闭失败,你,244,90,173,60,143,30,31.55893536121673
离灯_冬眠mode关闭失败,机,12,5,8,4,7,1,23.07692307692308
离灯_冬眠mode关闭失败,愿,12,6,9,3,6,3,20.0
离灯_冬眠mode关闭失败,可以,35,15,22,12,19,3,18.91891891891892
离灯_冬眠mode关闭失败,评论,14,3,4,1,2,2,14.285714285714285
离灯_冬眠mode关闭失败,打,27,11,14,10,13,1,12.0
离灯_冬眠mode关闭失败,看看,11,4,5,4,5,0,11.11111111111111
离灯_冬眠mode关闭失败,微博,23,12,15,6,9,6,11.11111111111111
离灯_冬眠mode关闭失败,别,13,5,6,5,6,0,9.090909090909092
离灯_冬眠mode关闭失败,离,17,11,13,4,6,7,8.333333333333332
醒醒我们回家了-走饭小号,大号,11,3,5,3,5,0,25.0
醒醒我们回家了-走饭小号,他们,15,6,9,6,9,0,20.0
头发有点儿杵脖子,风,15,1,14,1,14,0,86.66666666666667
头发有点儿杵脖子,漂亮,15,2,12,2,12,0,71.42857142857143
头发有点儿杵脖子,往,13,2,11,2,11,0,69.23076923076923
头发有点儿杵脖子,回来,17,4,16,1,13,3,60.0
头发有点儿杵脖子,今天,12,3,9,3,9,0,50.0
头发有点儿杵脖子,发,12,3,8,3,8,0,45.45454545454545
头发有点儿杵脖子,你,305,90,229,71,210,19,43.573667711598745
头发有点儿杵脖子,得,13,4,9,4,9,0,38.46153846153847
头发有点儿杵脖子,看到,14,4,9,3,8,1,38.46153846153847
头发有点儿杵脖子,下辈子,12,4,8,4,8,0,33.33333333333333
头发有点儿杵脖子,微博,22,7,14,6,13,1,33.33333333333333
头发有点儿杵脖子,快乐,28,11,21,6,16,5,31.25
头发有点儿杵脖子,一直,15,6,11,4,9,2,29.411764705882355
头发有点儿杵脖子,看看,15,5,9,5,9,0,28.57142857142857
头发有点儿杵脖子,美好,11,4,7,4,7,0,27.27272727272727
头发有点儿杵脖子,阿杵,43,18,30,13,25,5,25.0
头发有点儿杵脖子,希望,63,24,39,23,38,1,23.809523809523807
头发有点儿杵脖子,祝,17,8,12,4,8,4,20.0
头发有点儿杵脖子,选择,16,8,11,4,7,4,15.789473684210526
头发有点儿杵脖子,好,24,11,14,8,11,3,12.0
头发有点儿杵脖子,世界,33,15,19,13,17,2,11.76470588235294
头发有点儿杵脖子,可以,31,13,16,12,15,1,10.344827586206897
旅行的孤独风,北京,16,0,6,0,6,0,100.0
旅行的孤独风,好吗,11,1,10,1,10,0,81.81818181818183
旅行的孤独风,吃,15,3,13,1,11,2,62.5
旅行的孤独风,好不好,19,4,16,3,15,1,60.0
旅行的孤独风,请,17,4,14,1,11,3,55.55555555555556
旅行的孤独风,火锅,11,3,10,0,7,3,53.84615384615385
旅行的孤独风,愿,15,4,13,2,11,2,52.94117647058824
旅行的孤独风,带你,12,4,12,0,8,4,50.0
旅行的孤独风,美好,11,3,8,3,8,0,45.45454545454545
旅行的孤独风,还有,22,7,18,4,15,3,44.0
旅行的孤独风,别,12,4,9,2,7,2,38.46153846153847
旅行的孤独风,希望,33,11,24,7,20,4,37.142857142857146
旅行的孤独风,朋友,22,7,15,4,12,3,36.36363636363637
旅行的孤独风,我们,53,19,40,12,33,7,35.59322033898305
旅行的孤独风,你,308,110,230,72,192,38,35.294117647058826
旅行的孤独风,不要,20,4,8,4,8,0,33.33333333333333
旅行的孤独风,奶茶,11,4,8,2,6,2,33.33333333333333
旅行的孤独风,已经,28,10,19,6,15,4,31.03448275862069
旅行的孤独风,孤独,11,4,7,4,7,0,27.27272727272727
旅行的孤独风,把,17,7,12,4,9,3,26.31578947368421
旅行的孤独风,微博,18,7,11,6,10,1,22.22222222222222
旅行的孤独风,一定,15,6,9,6,9,0,20.0
旅行的孤独风,可以,42,18,26,15,23,3,18.181818181818183
旅行的孤独风,没有,38,16,23,15,22,1,17.94871794871795
玫瑰机关枪,想你,58,1,58,0,57,1,96.61016949152544
玫瑰机关枪,玫瑰,30,2,27,1,26,1,86.20689655172413
玫瑰机关枪,画,13,1,13,0,12,1,85.71428571428571
玫瑰机关枪,一直,12,1,12,0,11,1,84.61538461538461
玫瑰机关枪,姐姐,11,1,11,0,10,1,83.33333333333334
玫瑰机关枪,微博,15,1,10,1,10,0,81.81818181818183
玫瑰机关枪,你,201,21,199,2,180,19,80.9090909090909
玫瑰机关枪,一年,14,2,12,2,12,0,71.42857142857143
玫瑰机关枪,看到,11,2,11,0,9,2,69.23076923076923
玫瑰机关枪,已经,11,2,11,0,9,2,69.23076923076923
玫瑰机关枪,我们,24,4,22,2,20,2,69.23076923076923
玫瑰机关枪,代代,71,15,69,2,56,13,64.28571428571429
玫瑰机关枪,开心,17,4,17,0,13,4,61.90476190476191
玫瑰机关枪,想,12,3,12,0,9,3,60.0
玫瑰机关枪,爱,11,3,11,0,8,3,57.14285714285714
玫瑰机关枪,得,12,3,11,0,8,3,57.14285714285714
玫瑰机关枪,新年,18,5,18,0,13,5,56.52173913043478
玫瑰机关枪,快乐,26,7,25,1,19,6,56.25
玫瑰机关枪,希望,17,4,13,3,12,1,52.94117647058824
玫瑰机关枪,画画,12,4,11,1,8,3,46.66666666666666
玫瑰机关枪,现在,11,3,8,3,8,0,45.45454545454545
玫瑰机关枪,晚安,14,5,13,0,8,5,44.44444444444444
玫瑰机关枪,人,19,7,16,3,12,4,39.130434782608695
玫瑰机关枪,还是,16,6,13,3,10,3,36.84210526315789
十里清禾w,愿,14,1,13,1,13,0,85.71428571428571
十里清禾w,陪,11,1,11,0,10,1,83.33333333333334
十里清禾w,这么,11,2,11,0,9,2,69.23076923076923
十里清禾w,可爱,11,2,11,0,9,2,69.23076923076923
十里清禾w,这样,14,3,14,0,11,3,64.70588235294117
十里清禾w,开心,14,3,13,1,11,2,62.5
十里清禾w,喜欢,25,6,22,3,19,3,57.14285714285714
十里清禾w,你,302,86,295,7,216,79,54.85564304461942
十里清禾w,下辈子,15,5,15,0,10,5,50.0
十里清禾w,他们,16,4,12,4,12,0,50.0
十里清禾w,小,27,9,25,2,18,7,47.05882352941176
十里清禾w,最,14,4,11,3,10,1,46.66666666666666
十里清禾w,欣欣,16,6,16,0,10,6,45.45454545454545
十里清禾w,在那边,13,5,13,0,8,5,44.44444444444444
十里清禾w,一直,14,5,13,1,9,4,44.44444444444444
十里清禾w,姐姐,20,8,20,0,12,8,42.85714285714285
十里清禾w,成为,12,5,12,0,7,5,41.17647058823529
十里清禾w,一定,21,8,19,2,13,6,40.74074074074074
十里清禾w,可以,17,6,14,3,11,3,40.0
十里清禾w,那么,12,4,9,3,8,1,38.46153846153847
十里清禾w,看到,17,6,13,4,11,2,36.84210526315789
十里清禾w,温柔,37,15,32,5,22,10,36.17021276595745
十里清禾w,快乐,45,19,39,6,26,13,34.48275862068966
十里清禾w,老师,18,8,16,2,10,6,33.33333333333333
十里清禾w,事情,17,7,14,3,10,4,33.33333333333333
十里清禾w,得,14,6,12,2,8,4,33.33333333333333
十里清禾w,妹妹,73,31,62,10,41,21,33.33333333333333
十里清禾w,善良,12,6,11,1,6,5,29.411764705882355
十里清禾w,一个,22,10,18,4,12,6,28.57142857142857
十里清禾w,上,11,5,9,2,6,3,28.57142857142857
十里清禾w,好好,18,10,17,1,8,9,25.925925925925924
十里清禾w,美好,25,12,20,5,13,7,25.0
十里清禾w,晚安,41,24,39,2,17,22,23.809523809523807
十里清禾w,没有,27,13,21,6,14,7,23.52941176470588
十里清禾w,宝贝,19,12,19,0,7,12,22.58064516129032
十里清禾w,想,31,14,22,8,16,6,22.22222222222222
十里清禾w,我们,26,14,22,4,12,10,22.22222222222222
十里清禾w,她,17,9,14,3,8,6,21.73913043478261
十里清禾w,真的,15,9,14,1,6,8,21.73913043478261
十里清禾w,现在,26,15,23,3,11,12,21.052631578947366
十里清禾w,微博,14,9,13,1,5,8,18.181818181818183
十里清禾w,不是,17,9,13,4,8,5,18.181818181818183
十里清禾w,把,12,6,8,3,5,3,14.285714285714285
十里清禾w,生活,11,7,9,2,4,5,12.5
刘学州a,离开,11,0,11,0,11,0,100.0
刘学州a,再,18,1,17,0,16,1,88.88888888888889
刘学州a,宝贝,13,1,13,0,12,1,85.71428571428571
刘学州a,姐姐,14,1,12,1,12,0,84.61538461538461
刘学州a,现在,25,3,22,2,21,1,76.0
刘学州a,一定,33,5,29,4,28,1,70.58823529411765
刘学州a,你,517,86,487,30,431,56,69.9825479930192
刘学州a,他们,31,5,28,3,26,2,69.6969696969697
刘学州a,惩罚,12,2,11,1,10,1,69.23076923076923
刘学州a,学州,11,2,10,1,9,1,66.66666666666666
刘学州a,一定要,17,3,14,2,13,1,64.70588235294117
刘学州a,已经,27,5,23,3,21,2,64.28571428571429
刘学州a,有人,18,3,13,3,13,0,62.5
刘学州a,弟弟,43,9,38,4,33,5,61.70212765957447
刘学州a,因为,15,3,12,3,12,0,60.0
刘学州a,州州,43,11,39,4,32,7,56.00000000000001
刘学州a,今天,31,9,30,1,22,8,53.84615384615385
刘学州a,?,11,3,10,1,8,2,53.84615384615385
刘学州a,很多,12,3,10,2,9,1,53.84615384615385
刘学州a,走,17,5,16,1,12,4,52.38095238095239
刘学州a,还是,20,6,19,1,14,5,52.0
刘学州a,好好,23,7,22,1,16,6,51.72413793103448
刘学州a,上,17,5,15,2,12,3,50.0
刘学州a,世界,22,7,20,2,15,5,48.14814814814815
刘学州a,快乐,14,4,11,3,10,1,46.66666666666666
刘学州a,微博,13,3,8,3,8,0,45.45454545454545
刘学州a,如果,23,8,21,2,15,6,44.82758620689656
刘学州a,才,13,4,10,3,9,1,42.85714285714285
刘学州a,”,13,4,10,3,9,1,42.85714285714285
刘学州a,“,13,4,10,3,9,1,42.85714285714285
刘学州a,看到,21,6,15,6,15,0,42.85714285714285
刘学州a,但是,13,5,12,0,7,5,41.17647058823529
刘学州a,阿姨,12,5,12,0,7,5,41.17647058823529
刘学州a,爱,38,13,31,7,25,6,40.909090909090914
刘学州a,不要,24,8,19,4,15,4,40.74074074074074
刘学州a,好,33,12,28,5,21,7,40.0
刘学州a,三亚,19,4,9,2,7,2,38.46153846153847
刘学州a,把,25,8,18,6,16,2,38.46153846153847
刘学州a,不会,18,7,15,2,10,5,36.36363636363637
刘学州a,自杀,12,4,8,3,7,1,33.33333333333333
刘学州a,善良,11,4,8,3,7,1,33.33333333333333
刘学州a,活着,25,11,22,3,14,8,33.33333333333333
刘学州a,可以,31,11,21,8,18,3,31.25
刘学州a,真的,21,9,17,4,12,5,30.76923076923077
刘学州a,还有,17,7,13,3,9,4,30.0
刘学州a,希望,52,20,37,14,31,6,29.82456140350877
刘学州a,多,13,6,11,2,7,4,29.411764705882355
刘学州a,哭,13,6,11,2,7,4,29.411764705882355
刘学州a,愿,24,9,16,8,15,1,28.000000000000004
刘学州a,我们,50,22,39,11,28,11,27.86885245901639
刘学州a,我,225,100,177,46,123,54,27.79783393501805
刘学州a,关注,15,7,12,2,7,5,26.31578947368421
刘学州a,这个,30,12,20,6,14,6,25.0
刘学州a,人间,13,6,10,3,7,3,25.0
鸡蛋姬,永远,11,0,11,0,11,0,100.0
鸡蛋姬,一路走好,33,0,33,0,33,0,100.0
鸡蛋姬,认识,15,0,15,0,15,0,100.0
鸡蛋姬,方式,13,0,13,0,13,0,100.0
鸡蛋姬,小姐姐,12,0,12,0,12,0,100.0
鸡蛋姬,天堂,15,0,15,0,15,0,100.0
鸡蛋姬,不是,15,0,15,0,15,0,100.0
鸡蛋姬,自由,11,0,11,0,11,0,100.0
鸡蛋姬,优秀,11,0,11,0,11,0,100.0
鸡蛋姬,没有,22,1,22,0,21,1,91.30434782608695
鸡蛋姬,下辈子,20,1,20,0,19,1,90.47619047619048
鸡蛋姬,开心,18,1,18,0,17,1,89.47368421052632
鸡蛋姬,漂亮,30,2,30,0,28,2,87.5
鸡蛋姬,姐姐,59,4,58,1,55,3,87.09677419354838
鸡蛋姬,快乐,27,2,27,0,25,2,86.20689655172413
鸡蛋姬,幸福,26,2,26,0,24,2,85.71428571428571
鸡蛋姬,愿,26,2,26,0,24,2,85.71428571428571
鸡蛋姬,来世,12,1,12,0,11,1,84.61538461538461
鸡蛋姬,妹妹,12,1,12,0,11,1,84.61538461538461
鸡蛋姬,世界,36,3,34,2,33,1,83.78378378378379
鸡蛋姬,好看,12,1,11,1,11,0,83.33333333333334
鸡蛋姬,可以,11,1,11,0,10,1,83.33333333333334
鸡蛋姬,你,276,28,274,2,248,26,81.45695364238411
鸡蛋姬,还是,17,2,17,0,15,2,78.94736842105263
鸡蛋姬,希望,51,6,49,2,45,4,78.18181818181819
鸡蛋姬,我们,17,2,16,1,15,1,77.77777777777779
鸡蛋姬,在那边,15,2,15,0,13,2,76.47058823529412
鸡蛋姬,自己,21,3,20,1,18,2,73.91304347826086
鸡蛋姬,再,14,2,12,2,12,0,71.42857142857143
鸡蛋姬,染,13,2,12,1,11,1,71.42857142857143
鸡蛋姬,粉色,51,9,48,3,42,6,68.42105263157895
鸡蛋姬,人,21,4,20,1,17,3,66.66666666666666
鸡蛋姬,头发,37,7,35,2,30,5,66.66666666666666
鸡蛋姬,这个,21,4,19,2,17,2,65.21739130434783
走饭,饭饭,14,11,14,0,3,11,12.0
